vehicle_id,vehicle_type,tls_id,wait_start_time,wait_end_time,wait_duration
f_0.4,DEFAULT_VEHTYPE,122804862,12,13,1
f_0.5,DEFAULT_VEHTYPE,122804862,15,16,1
f_0.0,DEFAULT_VEHTYPE,GS_cluster_268162626_939854537,27,31,4
f_0.3,DEFAULT_VEHTYPE,122804862,17,43,26
f_0.4,DEFAULT_VEHTYPE,122804862,19,43,24
f_0.5,DEFAULT_VEHTYPE,122804862,20,43,23
bus2,bus,cluster_11693099831_444570416_6840545825_7059565461,45,49,4
f_0.8,DEFAULT_VEHTYPE,122804862,53,54,1
f_0.2,DEFAULT_VEHTYPE,122804862,15,59,44
f_0.10,DEFAULT_VEHTYPE,122804862,59,60,1
f_0.2,DEFAULT_VEHTYPE,GS_cluster_268162626_939854537,67,72,5
f_0.3,DEFAULT_VEHTYPE,GS_cluster_268162626_939854537,68,72,4
f_0.4,DEFAULT_VEHTYPE,GS_cluster_268162626_939854537,70,72,2
f_0.0,DEFAULT_VEHTYPE,122960160,74,78,4
f_0.10,DEFAULT_VEHTYPE,122804862,64,85,21
f_0.8,DEFAULT_VEHTYPE,122804862,61,85,24
f_0.9,DEFAULT_VEHTYPE,122804862,63,85,22
bus2,bus,cluster_11693099831_444570416_6840545825_7059565461,50,86,36
f_0.15,DEFAULT_VEHTYPE,122804862,102,103,1
f_0.7,DEFAULT_VEHTYPE,122804862,59,103,44
f_0.7,DEFAULT_VEHTYPE,GS_cluster_268162626_939854537,110,114,4
f_0.1,DEFAULT_VEHTYPE,122960160,110,126,16
f_0.13,DEFAULT_VEHTYPE,122804862,104,127,23
f_0.14,DEFAULT_VEHTYPE,122804862,106,127,21
f_0.15,DEFAULT_VEHTYPE,122804862,108,127,19
f_0.2,DEFAULT_VEHTYPE,122804862,126,127,1
bus1,bus,cluster_322079583_7059565429_7059565430_7059565458,114,139,25
f_0.12,DEFAULT_VEHTYPE,122804862,101,143,42
f_0.4,DEFAULT_VEHTYPE,122960160,123,143,20
f_0.20,DEFAULT_VEHTYPE,122804862,144,145,1
f_0.0,DEFAULT_VEHTYPE,122804862,116,147,31
f_0.3,DEFAULT_VEHTYPE,122960160,146,153,7
f_0.12,DEFAULT_VEHTYPE,GS_cluster_268162626_939854537,152,154,2
f_0.13,DEFAULT_VEHTYPE,GS_cluster_268162626_939854537,153,154,1
f_0.2,DEFAULT_VEHTYPE,122960160,144,154,10
f_0.18,DEFAULT_VEHTYPE,122804862,144,169,25
f_0.19,DEFAULT_VEHTYPE,122804862,146,169,23
f_0.2,DEFAULT_VEHTYPE,122804862,166,169,3
f_0.20,DEFAULT_VEHTYPE,122804862,147,169,22
f_0.5,DEFAULT_VEHTYPE,122804862,159,169,10
f_0.4,DEFAULT_VEHTYPE,122804862,154,170,16
bus1,bus,cluster_122966911_7059565450,169,171,2
f_0.6,DEFAULT_VEHTYPE,122960160,153,171,18
f_0.17,DEFAULT_VEHTYPE,122804862,143,186,43
f_0.25,DEFAULT_VEHTYPE,122804862,186,187,1
f_0.26,DEFAULT_VEHTYPE,122804862,189,190,1
f_0.17,DEFAULT_VEHTYPE,GS_cluster_268162626_939854537,195,198,3
f_0.18,DEFAULT_VEHTYPE,GS_cluster_268162626_939854537,197,198,1
f_0.9,DEFAULT_VEHTYPE,122960160,181,199,18
f_0.8,DEFAULT_VEHTYPE,122960160,180,202,22
bus1,bus,GS_cluster_7059565448_7059565449_7464757604_939854561,202,206,4
f_0.24,DEFAULT_VEHTYPE,122804862,190,212,22
f_0.25,DEFAULT_VEHTYPE,122804862,192,212,20
f_0.26,DEFAULT_VEHTYPE,122804862,194,212,18
f_0.4,DEFAULT_VEHTYPE,122804862,195,212,17
f_0.5,DEFAULT_VEHTYPE,122804862,199,212,13
f_0.6,DEFAULT_VEHTYPE,122804862,206,212,6
f_0.8,DEFAULT_VEHTYPE,122804862,210,212,2
f_0.7,DEFAULT_VEHTYPE,122804862,187,214,27
f_0.3,DEFAULT_VEHTYPE,5703666296,203,223,20
f_0.23,DEFAULT_VEHTYPE,122804862,187,230,43
f_0.31,DEFAULT_VEHTYPE,122804862,229,230,1
f_0.13,DEFAULT_VEHTYPE,122960160,219,232,13
f_0.32,DEFAULT_VEHTYPE,122804862,232,233,1
f_0.12,DEFAULT_VEHTYPE,122960160,217,235,18
f_0.23,DEFAULT_VEHTYPE,GS_cluster_268162626_939854537,238,241,3
f_0.8,DEFAULT_VEHTYPE,122960160,237,244,7
f_0.14,DEFAULT_VEHTYPE,122960160,243,247,4
f_0.15,DEFAULT_VEHTYPE,122960160,245,247,2
f_0.11,DEFAULT_VEHTYPE,122804862,236,255,19
f_0.12,DEFAULT_VEHTYPE,122804862,244,255,11
f_0.13,DEFAULT_VEHTYPE,122804862,246,255,9
f_0.30,DEFAULT_VEHTYPE,122804862,233,255,22
f_0.31,DEFAULT_VEHTYPE,122804862,235,255,20
f_0.32,DEFAULT_VEHTYPE,122804862,237,255,18
f_0.7,DEFAULT_VEHTYPE,122804862,238,255,17
f_0.10,DEFAULT_VEHTYPE,122804862,234,256,22
f_0.6,DEFAULT_VEHTYPE,5703666296,248,271,23
f_0.29,DEFAULT_VEHTYPE,122804862,231,272,41
f_0.17,DEFAULT_VEHTYPE,122960160,261,277,16
f_0.16,DEFAULT_VEHTYPE,122960160,258,280,22
f_0.39,DEFAULT_VEHTYPE,122804862,279,280,1
f_0.29,DEFAULT_VEHTYPE,GS_cluster_268162626_939854537,281,283,2
f_0.30,DEFAULT_VEHTYPE,GS_cluster_268162626_939854537,282,283,1
f_0.40,DEFAULT_VEHTYPE,122804862,282,283,1
f_0.39,DEFAULT_VEHTYPE,122804862,285,286,1
f_0.41,DEFAULT_VEHTYPE,122804862,285,286,1
f_0.12,DEFAULT_VEHTYPE,122960160,280,287,7
f_0.13,DEFAULT_VEHTYPE,122960160,282,287,5
f_0.11,DEFAULT_VEHTYPE,122960160,272,288,16
f_0.18,DEFAULT_VEHTYPE,122960160,287,291,4
f_0.19,DEFAULT_VEHTYPE,122960160,289,291,2
f_0.10,DEFAULT_VEHTYPE,122804862,284,303,19
f_0.11,DEFAULT_VEHTYPE,122804862,298,303,5
f_0.12,DEFAULT_VEHTYPE,122804862,301,303,2
f_0.15,DEFAULT_VEHTYPE,122804862,282,303,21
f_0.16,DEFAULT_VEHTYPE,122804862,291,303,12
f_0.17,DEFAULT_VEHTYPE,122804862,293,303,10
f_0.38,DEFAULT_VEHTYPE,122804862,285,303,18
f_0.39,DEFAULT_VEHTYPE,122804862,287,303,16
f_0.40,DEFAULT_VEHTYPE,122804862,288,303,15
f_0.41,DEFAULT_VEHTYPE,122804862,290,303,13
f_0.8,DEFAULT_VEHTYPE,5703666296,298,310,12
f_0.14,DEFAULT_VEHTYPE,122960160,296,318,22
f_0.13,DEFAULT_VEHTYPE,122960160,295,319,24
f_0.38,DEFAULT_VEHTYPE,GS_cluster_268162626_939854537,327,330,3
f_0.16,DEFAULT_VEHTYPE,122960160,331,332,1
f_0.26,DEFAULT_VEHTYPE,122960160,319,351,32
f_0.25,DEFAULT_VEHTYPE,122960160,317,354,37
f_0.11,DEFAULT_VEHTYPE,5703666296,343,355,12
f_0.57,DEFAULT_VEHTYPE,122804862,354,355,1
f_0.58,DEFAULT_VEHTYPE,122804862,357,358,1
f_0.21,DEFAULT_VEHTYPE,122960160,351,361,10
f_0.22,DEFAULT_VEHTYPE,122960160,352,361,9
f_0.23,DEFAULT_VEHTYPE,122960160,353,361,8
f_0.24,DEFAULT_VEHTYPE,122960160,359,361,2
f_0.59,DEFAULT_VEHTYPE,122804862,360,361,1
f_0.20,DEFAULT_VEHTYPE,122960160,350,362,12
f_0.16,DEFAULT_VEHTYPE,122804862,358,381,23
f_0.17,DEFAULT_VEHTYPE,122804862,360,381,21
f_0.18,DEFAULT_VEHTYPE,122804862,361,381,20
f_0.19,DEFAULT_VEHTYPE,122804862,363,381,18
f_0.20,DEFAULT_VEHTYPE,122804862,371,381,10
f_0.21,DEFAULT_VEHTYPE,122804862,374,381,7
f_0.22,DEFAULT_VEHTYPE,122804862,378,381,3
f_0.25,DEFAULT_VEHTYPE,122804862,366,381,15
f_0.26,DEFAULT_VEHTYPE,122804862,367,381,14
f_0.28,DEFAULT_VEHTYPE,122960160,363,381,18
f_0.57,DEFAULT_VEHTYPE,122804862,363,381,18
f_0.58,DEFAULT_VEHTYPE,122804862,364,381,17
f_0.59,DEFAULT_VEHTYPE,122804862,365,381,16
f_0.27,DEFAULT_VEHTYPE,122960160,362,384,22
f_0.24,DEFAULT_VEHTYPE,122960160,378,391,13
f_0.13,DEFAULT_VEHTYPE,5703666296,371,394,23
f_0.56,DEFAULT_VEHTYPE,122804862,359,399,40
f_0.15,DEFAULT_VEHTYPE,122804862,357,404,47
f_0.14,DEFAULT_VEHTYPE,5703666296,402,405,3
f_0.30,DEFAULT_VEHTYPE,122960160,392,406,14
f_0.29,DEFAULT_VEHTYPE,122960160,391,409,18
f_0.56,DEFAULT_VEHTYPE,GS_cluster_268162626_939854537,408,410,2
f_0.25,DEFAULT_VEHTYPE,122960160,410,412,2
f_0.32,DEFAULT_VEHTYPE,122960160,418,421,3
f_0.31,DEFAULT_VEHTYPE,122960160,416,424,8
f_0.72,DEFAULT_VEHTYPE,122804862,424,425,1
f_0.29,DEFAULT_VEHTYPE,122804862,424,428,4
f_0.30,DEFAULT_VEHTYPE,122804862,425,428,3
f_0.70,DEFAULT_VEHTYPE,122804862,425,428,3
f_0.73,DEFAULT_VEHTYPE,122804862,427,428,1
f_0.27,DEFAULT_VEHTYPE,122960160,427,431,4
f_0.28,DEFAULT_VEHTYPE,122960160,430,431,1
f_0.26,DEFAULT_VEHTYPE,122960160,419,433,14
f_0.76,DEFAULT_VEHTYPE,122804862,440,441,1
f_0.77,DEFAULT_VEHTYPE,122804862,443,444,1
f_0.21,DEFAULT_VEHTYPE,5703666296,430,449,19
f_0.34,DEFAULT_VEHTYPE,122960160,434,449,15
f_0.33,DEFAULT_VEHTYPE,122960160,432,452,20
f_0.65,DEFAULT_VEHTYPE,GS_cluster_268162626_939854537,461,462,1
f_0.66,DEFAULT_VEHTYPE,GS_cluster_268162626_939854537,461,463,2
f_0.67,DEFAULT_VEHTYPE,GS_cluster_268162626_939854537,461,464,3
f_0.63,DEFAULT_VEHTYPE,GS_cluster_268162626_939854537,464,465,1
f_0.68,DEFAULT_VEHTYPE,GS_cluster_268162626_939854537,461,465,4
f_0.26,DEFAULT_VEHTYPE,122804862,444,466,22
f_0.27,DEFAULT_VEHTYPE,122804862,447,466,19
f_0.28,DEFAULT_VEHTYPE,122804862,450,466,16
f_0.29,DEFAULT_VEHTYPE,122804862,455,466,11
f_0.32,DEFAULT_VEHTYPE,122804862,442,466,24
f_0.33,DEFAULT_VEHTYPE,122804862,460,466,6
f_0.34,DEFAULT_VEHTYPE,122804862,462,466,4
f_0.69,DEFAULT_VEHTYPE,GS_cluster_268162626_939854537,461,466,5
f_0.75,DEFAULT_VEHTYPE,122804862,445,466,21
f_0.76,DEFAULT_VEHTYPE,122804862,446,466,20
f_0.77,DEFAULT_VEHTYPE,122804862,448,466,18
f_0.31,DEFAULT_VEHTYPE,122804862,439,467,28
f_0.30,DEFAULT_VEHTYPE,122960160,447,470,23
f_0.38,DEFAULT_VEHTYPE,122960160,469,487,18
f_0.37,DEFAULT_VEHTYPE,122960160,468,490,22
f_0.63,DEFAULT_VEHTYPE,GS_cluster_268162626_939854537,469,496,27
f_0.64,DEFAULT_VEHTYPE,GS_cluster_268162626_939854537,471,496,25
f_0.65,DEFAULT_VEHTYPE,GS_cluster_268162626_939854537,472,496,24
f_0.66,DEFAULT_VEHTYPE,GS_cluster_268162626_939854537,476,496,20
f_0.67,DEFAULT_VEHTYPE,GS_cluster_268162626_939854537,477,496,19
f_0.68,DEFAULT_VEHTYPE,GS_cluster_268162626_939854537,479,496,17
f_0.69,DEFAULT_VEHTYPE,GS_cluster_268162626_939854537,481,496,15
f_0.70,DEFAULT_VEHTYPE,GS_cluster_268162626_939854537,480,496,16
f_0.71,DEFAULT_VEHTYPE,GS_cluster_268162626_939854537,483,496,13
f_0.86,DEFAULT_VEHTYPE,122804862,495,496,1
f_0.32,DEFAULT_VEHTYPE,122960160,483,498,15
f_0.87,DEFAULT_VEHTYPE,122804862,498,499,1
f_0.39,DEFAULT_VEHTYPE,122960160,497,502,5
f_0.40,DEFAULT_VEHTYPE,122960160,499,502,3
f_0.30,DEFAULT_VEHTYPE,122804862,497,513,16
f_0.31,DEFAULT_VEHTYPE,122804862,499,513,14
f_0.32,DEFAULT_VEHTYPE,122804862,509,513,4
f_0.33,DEFAULT_VEHTYPE,122804862,512,513,1
f_0.35,DEFAULT_VEHTYPE,122960160,508,513,5
f_0.36,DEFAULT_VEHTYPE,122804862,495,513,18
f_0.37,DEFAULT_VEHTYPE,122804862,502,513,11
f_0.38,DEFAULT_VEHTYPE,122804862,502,513,11
f_0.84,DEFAULT_VEHTYPE,122804862,497,513,16
f_0.85,DEFAULT_VEHTYPE,122804862,498,513,15
f_0.86,DEFAULT_VEHTYPE,122804862,501,513,12
f_0.87,DEFAULT_VEHTYPE,122804862,503,513,10
f_0.74,DEFAULT_VEHTYPE,122804862,442,514,72
f_0.34,DEFAULT_VEHTYPE,122960160,506,515,9
