vehicle_id,vehicle_type,tls_id,wait_start_time,wait_end_time,wait_duration
bus1,bus,36635979,0,1,1
car3.0,DEFAULT_VEHTYPE,122763218,0,1,1
car3.1,DEFAULT_VEHTYPE,122763218,5,6,1
bus1,bus,36635979,6,16,10
car4.0,DEFAULT_VEHTYPE,123160850,15,18,3
car3.4,DEFAULT_VEHTYPE,122763218,18,19,1
car6.0,DEFAULT_VEHTYPE,36635979,19,21,2
car1.0,DEFAULT_VEHTYPE,36635979,15,25,10
car3.6,DEFAULT_VEHTYPE,122763218,27,28,1
car3.7,DEFAULT_VEHTYPE,122763218,32,33,1
car1.0,DEFAULT_VEHTYPE,852777135,31,35,4
car3.4,DEFAULT_VEHTYPE,122763218,35,37,2
car3.8,DEFAULT_VEHTYPE,122763218,36,37,1
bus4,bus,cluster_1832615131_4075599903_5942692697_5942692700,19,38,19
car1.4,DEFAULT_VEHTYPE,36635979,34,38,4
car2.1,DEFAULT_VEHTYPE,36635968,37,39,2
car1.2,DEFAULT_VEHTYPE,36635979,25,47,22
car1.3,DEFAULT_VEHTYPE,36635979,30,47,17
bus3,bus,16218739,20,49,29
car3.11,DEFAULT_VEHTYPE,122763218,50,51,1
bus2,bus,122574908,30,54,24
car3.12,DEFAULT_VEHTYPE,122763218,54,55,1
car6.5,DEFAULT_VEHTYPE,36635979,38,58,20
car6.6,DEFAULT_VEHTYPE,36635979,43,58,15
car6.7,DEFAULT_VEHTYPE,36635979,48,58,10
car6.8,DEFAULT_VEHTYPE,36635979,52,58,6
car6.9,DEFAULT_VEHTYPE,36635979,56,58,2
car3.13,DEFAULT_VEHTYPE,122763218,59,60,1
car1.1,DEFAULT_VEHTYPE,36635976,58,62,4
car3.10,DEFAULT_VEHTYPE,122763218,61,62,1
car3.9,DEFAULT_VEHTYPE,122763218,58,62,4
car2.2,DEFAULT_VEHTYPE,36635968,38,63,25
car4.10,DEFAULT_VEHTYPE,123160850,60,63,3
car4.3,DEFAULT_VEHTYPE,123160850,30,63,33
car4.4,DEFAULT_VEHTYPE,123160850,34,63,29
car4.5,DEFAULT_VEHTYPE,123160850,38,63,25
car4.6,DEFAULT_VEHTYPE,123160850,43,63,20
car4.7,DEFAULT_VEHTYPE,123160850,48,63,15
car4.8,DEFAULT_VEHTYPE,123160850,51,63,12
car4.9,DEFAULT_VEHTYPE,123160850,57,63,6
car3.3,DEFAULT_VEHTYPE,122763218,31,66,35
car5.0,DEFAULT_VEHTYPE,122830043,31,66,35
car2.0,DEFAULT_VEHTYPE,36635968,31,67,36
bus1,bus,852777135,41,68,27
car1.3,DEFAULT_VEHTYPE,852777135,54,68,14
car1.4,DEFAULT_VEHTYPE,852777135,55,68,13
car1.5,DEFAULT_VEHTYPE,852777135,56,68,12
car1.6,DEFAULT_VEHTYPE,852777135,59,68,9
car1.7,DEFAULT_VEHTYPE,852777135,57,68,11
car3.2,DEFAULT_VEHTYPE,1686594173,57,68,11
car5.2,DEFAULT_VEHTYPE,122865866,22,68,46
car6.4,DEFAULT_VEHTYPE,36635979,36,72,36
car4.0,DEFAULT_VEHTYPE,123160850,19,73,54
car4.2,DEFAULT_VEHTYPE,123160850,26,73,47
car6.3,DEFAULT_VEHTYPE,36635979,30,73,43
car4.1,DEFAULT_VEHTYPE,123160850,20,74,54
car5.0,DEFAULT_VEHTYPE,1686594171,71,74,3
car6.1,DEFAULT_VEHTYPE,GS_cluster_10738391828_178489893,72,76,4
bus4,bus,1686594183,74,78,4
car2.10,DEFAULT_VEHTYPE,36635968,73,80,7
car1.10,DEFAULT_VEHTYPE,36635979,60,81,21
car1.11,DEFAULT_VEHTYPE,36635979,64,81,17
car1.12,DEFAULT_VEHTYPE,36635979,67,81,14
car1.13,DEFAULT_VEHTYPE,36635979,73,81,8
car1.14,DEFAULT_VEHTYPE,36635979,76,81,5
car3.18,DEFAULT_VEHTYPE,122763218,81,82,1
bus3,bus,122575436,69,84,15
car1.2,DEFAULT_VEHTYPE,852777135,53,86,33
car3.1,DEFAULT_VEHTYPE,1686594173,54,87,33
car3.19,DEFAULT_VEHTYPE,122763218,86,87,1
car1.9,DEFAULT_VEHTYPE,36635979,56,90,34
car3.16,DEFAULT_VEHTYPE,122763218,87,90,3
car1.8,DEFAULT_VEHTYPE,36635979,50,91,41
car3.8,DEFAULT_VEHTYPE,122763218,54,92,38
car5.1,DEFAULT_VEHTYPE,122865866,19,93,74
car4.10,DEFAULT_VEHTYPE,3769264120,93,96,3
car4.12,DEFAULT_VEHTYPE,3769264120,92,96,4
car4.13,DEFAULT_VEHTYPE,3769264120,94,96,2
car4.3,DEFAULT_VEHTYPE,3769264120,87,96,9
car4.4,DEFAULT_VEHTYPE,3769264120,89,96,7
car4.5,DEFAULT_VEHTYPE,3769264120,90,96,6
car4.6,DEFAULT_VEHTYPE,3769264120,87,96,9
car4.7,DEFAULT_VEHTYPE,3769264120,91,96,5
car4.8,DEFAULT_VEHTYPE,3769264120,92,96,4
car4.9,DEFAULT_VEHTYPE,3769264120,90,96,6
car6.2,DEFAULT_VEHTYPE,122763218,64,96,32
car6.0,DEFAULT_VEHTYPE,122763218,65,98,33
car1.0,DEFAULT_VEHTYPE,122596361,82,99,17
car1.1,DEFAULT_VEHTYPE,122596361,82,99,17
car6.1,DEFAULT_VEHTYPE,GS_cluster_122686655_1833694983,95,99,4
car2.3,DEFAULT_VEHTYPE,11331520849,96,100,4
car3.8,DEFAULT_VEHTYPE,1686594173,97,101,4
car3.9,DEFAULT_VEHTYPE,1686594173,100,101,1
car1.12,DEFAULT_VEHTYPE,852777135,101,102,1
car1.3,DEFAULT_VEHTYPE,36635976,97,102,5
car1.6,DEFAULT_VEHTYPE,36635976,98,102,4
car1.7,DEFAULT_VEHTYPE,36635976,95,102,7
car3.23,DEFAULT_VEHTYPE,122763218,104,105,1
car4.0,DEFAULT_VEHTYPE,3769264120,86,105,19
car4.2,DEFAULT_VEHTYPE,3769264120,85,105,20
car6.5,DEFAULT_VEHTYPE,122763218,101,105,4
car6.6,DEFAULT_VEHTYPE,122763218,101,105,4
car6.7,DEFAULT_VEHTYPE,122763218,103,105,2
car6.8,DEFAULT_VEHTYPE,122763218,102,105,3
bus4,bus,cluster_14963716_27976732_3892769467,103,106,3
car4.1,DEFAULT_VEHTYPE,3769264120,85,106,21
car5.0,DEFAULT_VEHTYPE,122686666,88,106,18
car1.10,DEFAULT_VEHTYPE,852777135,101,107,6
car1.11,DEFAULT_VEHTYPE,852777135,100,107,7
car1.12,DEFAULT_VEHTYPE,852777135,103,107,4
car1.13,DEFAULT_VEHTYPE,852777135,101,107,6
car1.14,DEFAULT_VEHTYPE,852777135,104,107,3
car1.15,DEFAULT_VEHTYPE,852777135,103,107,4
car1.16,DEFAULT_VEHTYPE,852777135,106,107,1
car1.17,DEFAULT_VEHTYPE,852777135,104,107,3
car1.18,DEFAULT_VEHTYPE,852777135,106,107,1
car1.8,DEFAULT_VEHTYPE,852777135,98,107,9
car2.9,DEFAULT_VEHTYPE,36635968,71,107,36
car6.15,DEFAULT_VEHTYPE,36635979,85,107,22
car6.16,DEFAULT_VEHTYPE,36635979,89,107,18
car6.17,DEFAULT_VEHTYPE,36635979,91,107,16
car6.18,DEFAULT_VEHTYPE,36635979,96,107,11
car6.19,DEFAULT_VEHTYPE,36635979,100,107,7
car6.20,DEFAULT_VEHTYPE,36635979,104,107,3
car3.24,DEFAULT_VEHTYPE,122763218,108,109,1
car2.8,DEFAULT_VEHTYPE,36635968,69,110,41
car3.0,DEFAULT_VEHTYPE,122830043,63,111,48
car1.5,DEFAULT_VEHTYPE,36635976,92,112,20
bus2,bus,122574905,74,113,39
car1.2,DEFAULT_VEHTYPE,36635976,91,113,22
car3.25,DEFAULT_VEHTYPE,122763218,113,114,1
car4.15,DEFAULT_VEHTYPE,123160850,83,117,34
car4.17,DEFAULT_VEHTYPE,123160850,91,117,26
car4.18,DEFAULT_VEHTYPE,123160850,97,117,20
car4.19,DEFAULT_VEHTYPE,123160850,103,117,14
car4.20,DEFAULT_VEHTYPE,123160850,105,117,12
car4.21,DEFAULT_VEHTYPE,123160850,112,117,5
car4.22,DEFAULT_VEHTYPE,123160850,114,117,3
car3.26,DEFAULT_VEHTYPE,122763218,117,118,1
car3.7,DEFAULT_VEHTYPE,1686594173,85,118,33
car6.4,DEFAULT_VEHTYPE,122763218,98,120,22
car3.21,DEFAULT_VEHTYPE,122763218,111,121,10
car6.13,DEFAULT_VEHTYPE,36635979,78,121,43
car6.14,DEFAULT_VEHTYPE,36635979,81,121,40
car6.3,DEFAULT_VEHTYPE,122763218,99,121,22
car3.15,DEFAULT_VEHTYPE,122763218,85,122,37
car3.22,DEFAULT_VEHTYPE,122763218,113,122,9
car2.19,DEFAULT_VEHTYPE,36635968,117,123,6
car2.20,DEFAULT_VEHTYPE,36635968,119,123,4
car3.23,DEFAULT_VEHTYPE,122763218,118,123,5
car3.27,DEFAULT_VEHTYPE,122763218,122,123,1
car5.1,DEFAULT_VEHTYPE,122830043,94,123,29
bus3,bus,122899891,90,124,34
car1.9,DEFAULT_VEHTYPE,852777135,97,125,28
car3.28,DEFAULT_VEHTYPE,122763218,126,127,1
car4.11,DEFAULT_VEHTYPE,123160850,76,127,51
car4.14,DEFAULT_VEHTYPE,123160850,78,127,49
car4.16,DEFAULT_VEHTYPE,123160850,88,127,39
car1.4,DEFAULT_VEHTYPE,852777135,78,128,50
car3.22,DEFAULT_VEHTYPE,122763218,127,128,1
car5.0,DEFAULT_VEHTYPE,122574871,110,128,18
car6.16,DEFAULT_VEHTYPE,122763222,127,128,1
car2.10,DEFAULT_VEHTYPE,cluster_1832615131_4075599903_5942692697_5942692700,117,130,13
car2.13,DEFAULT_VEHTYPE,cluster_1832615131_4075599903_5942692697_5942692700,117,130,13
car2.14,DEFAULT_VEHTYPE,cluster_1832615131_4075599903_5942692697_5942692700,119,130,11
car2.8,DEFAULT_VEHTYPE,cluster_1832615131_4075599903_5942692697_5942692700,115,130,15
car2.9,DEFAULT_VEHTYPE,cluster_1832615131_4075599903_5942692697_5942692700,112,130,18
car5.8,DEFAULT_VEHTYPE,122865866,86,130,44
car6.2,DEFAULT_VEHTYPE,GS_cluster_10738391828_178489893,100,130,30
car4.0,DEFAULT_VEHTYPE,32581278,128,131,3
car6.0,DEFAULT_VEHTYPE,GS_cluster_10738391828_178489893,102,131,29
car2.6,DEFAULT_VEHTYPE,122865866,130,133,3
car1.0,DEFAULT_VEHTYPE,122865866,104,135,31
car1.21,DEFAULT_VEHTYPE,36635979,110,135,25
car1.22,DEFAULT_VEHTYPE,36635979,114,135,21
car1.23,DEFAULT_VEHTYPE,36635979,117,135,18
car1.24,DEFAULT_VEHTYPE,36635979,125,135,10
car1.25,DEFAULT_VEHTYPE,36635979,126,135,9
car1.26,DEFAULT_VEHTYPE,36635979,130,135,5
bus2,bus,122574902,118,136,18
car3.16,DEFAULT_VEHTYPE,1686594173,129,137,8
car3.17,DEFAULT_VEHTYPE,1686594173,131,137,6
car3.18,DEFAULT_VEHTYPE,1686594173,133,137,4
car3.19,DEFAULT_VEHTYPE,1686594173,135,137,2
car6.1,DEFAULT_VEHTYPE,GS_cluster_18314684_1833694981,116,137,21
car5.2,DEFAULT_VEHTYPE,1686594171,131,139,8
car5.3,DEFAULT_VEHTYPE,1686594171,132,139,7
car5.4,DEFAULT_VEHTYPE,1686594171,135,139,4
car4.15,DEFAULT_VEHTYPE,123160859,136,140,4
car4.17,DEFAULT_VEHTYPE,123160859,134,140,6
car4.18,DEFAULT_VEHTYPE,123160859,137,140,3
car4.19,DEFAULT_VEHTYPE,123160859,136,140,4
car4.20,DEFAULT_VEHTYPE,123160859,136,140,4
car4.21,DEFAULT_VEHTYPE,123160859,139,140,1
car4.22,DEFAULT_VEHTYPE,123160859,138,140,2
car4.23,DEFAULT_VEHTYPE,123160859,137,140,3
car4.24,DEFAULT_VEHTYPE,123160859,139,140,1
car6.4,DEFAULT_VEHTYPE,GS_cluster_122686655_1833694983,140,141,1
car1.10,DEFAULT_VEHTYPE,36635976,138,143,5
car1.11,DEFAULT_VEHTYPE,36635976,135,143,8
car1.12,DEFAULT_VEHTYPE,36635976,140,143,3
car1.13,DEFAULT_VEHTYPE,36635976,137,143,6
car1.15,DEFAULT_VEHTYPE,36635976,138,143,5
car1.17,DEFAULT_VEHTYPE,36635976,139,143,4
car1.4,DEFAULT_VEHTYPE,36635976,133,143,10
car1.8,DEFAULT_VEHTYPE,36635976,135,143,8
car5.1,DEFAULT_VEHTYPE,1686594171,129,143,14
car1.19,DEFAULT_VEHTYPE,36635979,100,144,44
car1.20,DEFAULT_VEHTYPE,36635979,106,144,38
car6.20,DEFAULT_VEHTYPE,122763222,140,144,4
car6.22,DEFAULT_VEHTYPE,122763222,142,144,2
car6.3,DEFAULT_VEHTYPE,GS_cluster_122686655_1833694983,140,145,5
car6.5,DEFAULT_VEHTYPE,GS_cluster_122686655_1833694983,141,145,4
car6.7,DEFAULT_VEHTYPE,GS_cluster_122686655_1833694983,144,145,1
bus4,bus,14963731,143,146,3
car4.11,DEFAULT_VEHTYPE,123160859,133,147,14
car4.14,DEFAULT_VEHTYPE,123160859,133,147,14
car4.16,DEFAULT_VEHTYPE,123160859,133,147,14
car6.14,DEFAULT_VEHTYPE,122763222,126,148,22
car3.20,DEFAULT_VEHTYPE,122763218,107,150,43
car2.17,DEFAULT_VEHTYPE,36635968,109,151,42
car2.18,DEFAULT_VEHTYPE,36635968,111,151,40
car6.1,DEFAULT_VEHTYPE,122763207,143,151,8
car1.6,DEFAULT_VEHTYPE,36635976,123,153,30
car3.10,DEFAULT_VEHTYPE,122830043,136,153,17
car3.11,DEFAULT_VEHTYPE,122830043,137,153,16
car3.12,DEFAULT_VEHTYPE,122830043,140,153,13
car3.13,DEFAULT_VEHTYPE,122830043,141,153,12
car3.14,DEFAULT_VEHTYPE,122830043,142,153,11
car3.8,DEFAULT_VEHTYPE,122830043,133,153,20
car3.9,DEFAULT_VEHTYPE,122830043,135,153,18
car1.9,DEFAULT_VEHTYPE,36635976,132,154,22
car3.34,DEFAULT_VEHTYPE,122763218,153,154,1
car2.7,DEFAULT_VEHTYPE,cluster_1832615131_4075599903_5942692697_5942692700,86,156,70
car3.21,DEFAULT_VEHTYPE,122763218,125,156,31
car6.2,DEFAULT_VEHTYPE,GS_cluster_122686655_1833694983,138,156,18
car3.15,DEFAULT_VEHTYPE,1686594173,128,157,29
car5.0,DEFAULT_VEHTYPE,123527068,134,157,23
car2.11,DEFAULT_VEHTYPE,cluster_1832615131_4075599903_5942692697_5942692700,115,159,44
car3.35,DEFAULT_VEHTYPE,122763218,158,159,1
car6.0,DEFAULT_VEHTYPE,GS_cluster_122686655_1833694983,139,160,21
car5.10,DEFAULT_VEHTYPE,122865866,141,161,20
car6.27,DEFAULT_VEHTYPE,36635979,136,161,25
car6.28,DEFAULT_VEHTYPE,36635979,142,161,19
car6.29,DEFAULT_VEHTYPE,36635979,146,161,15
car6.30,DEFAULT_VEHTYPE,36635979,152,161,9
car6.31,DEFAULT_VEHTYPE,36635979,155,161,6
car6.32,DEFAULT_VEHTYPE,36635979,159,161,2
bus3,bus,122596240,154,162,8
car3.32,DEFAULT_VEHTYPE,122763218,162,163,1
car3.36,DEFAULT_VEHTYPE,122763218,162,163,1
car6.18,DEFAULT_VEHTYPE,122763222,137,163,26
car3.23,DEFAULT_VEHTYPE,1686594173,165,166,1
car6.3,DEFAULT_VEHTYPE,GS_cluster_18314684_1833694981,164,166,2
car6.5,DEFAULT_VEHTYPE,GS_cluster_18314684_1833694981,166,167,1
car6.7,DEFAULT_VEHTYPE,GS_cluster_18314684_1833694981,166,167,1
car6.1,DEFAULT_VEHTYPE,122763204,158,168,10
car1.19,DEFAULT_VEHTYPE,852777135,151,169,18
car2.5,DEFAULT_VEHTYPE,11331520849,108,169,61
car6.14,DEFAULT_VEHTYPE,122763218,154,169,15
car2.30,DEFAULT_VEHTYPE,36635968,164,170,6
car2.4,DEFAULT_VEHTYPE,11331520849,112,170,58
car4.15,DEFAULT_VEHTYPE,3769264120,157,170,13
car4.17,DEFAULT_VEHTYPE,3769264120,157,170,13
car4.18,DEFAULT_VEHTYPE,3769264120,158,170,12
car4.19,DEFAULT_VEHTYPE,3769264120,157,170,13
car4.20,DEFAULT_VEHTYPE,3769264120,159,170,11
car4.21,DEFAULT_VEHTYPE,3769264120,160,170,10
car4.22,DEFAULT_VEHTYPE,3769264120,158,170,12
car4.23,DEFAULT_VEHTYPE,3769264120,161,170,9
car4.24,DEFAULT_VEHTYPE,3769264120,163,170,7
car4.25,DEFAULT_VEHTYPE,3769264120,160,170,10
car1.20,DEFAULT_VEHTYPE,852777135,150,171,21
car3.7,DEFAULT_VEHTYPE,122830043,128,171,43
car6.9,DEFAULT_VEHTYPE,GS_cluster_18314684_1833694981,171,172,1
car3.22,DEFAULT_VEHTYPE,1686594173,164,174,10
car3.23,DEFAULT_VEHTYPE,1686594173,167,174,7
car3.24,DEFAULT_VEHTYPE,1686594173,169,174,5
car3.25,DEFAULT_VEHTYPE,1686594173,171,174,3
car6.25,DEFAULT_VEHTYPE,36635979,128,174,46
car6.26,DEFAULT_VEHTYPE,36635979,134,174,40
car1.2,DEFAULT_VEHTYPE,11331520849,170,175,5
car2.10,DEFAULT_VEHTYPE,11331520849,174,175,1
car2.11,DEFAULT_VEHTYPE,11331520849,166,175,9
car2.12,DEFAULT_VEHTYPE,11331520849,171,175,4
car2.13,DEFAULT_VEHTYPE,11331520849,169,175,6
car2.14,DEFAULT_VEHTYPE,11331520849,171,175,4
car2.15,DEFAULT_VEHTYPE,11331520849,174,175,1
car2.8,DEFAULT_VEHTYPE,11331520849,173,175,2
car4.29,DEFAULT_VEHTYPE,123160850,148,175,27
car4.31,DEFAULT_VEHTYPE,123160850,156,175,19
car4.32,DEFAULT_VEHTYPE,123160850,159,175,16
car4.33,DEFAULT_VEHTYPE,123160850,166,175,9
car4.34,DEFAULT_VEHTYPE,123160850,168,175,7
car4.35,DEFAULT_VEHTYPE,123160850,172,175,3
car4.26,DEFAULT_VEHTYPE,123160859,151,177,26
car6.11,DEFAULT_VEHTYPE,GS_cluster_18314684_1833694981,174,178,4
car4.14,DEFAULT_VEHTYPE,3769264120,155,179,24
car4.11,DEFAULT_VEHTYPE,3769264120,155,180,25
car4.16,DEFAULT_VEHTYPE,3769264120,154,180,26
car6.0,DEFAULT_VEHTYPE,GS_cluster_18314684_1833694981,170,180,10
car6.10,DEFAULT_VEHTYPE,GS_cluster_18314684_1833694981,174,180,6
car6.12,DEFAULT_VEHTYPE,GS_cluster_18314684_1833694981,164,180,16
car6.5,DEFAULT_VEHTYPE,GS_cluster_18314684_1833694981,168,180,12
car6.6,DEFAULT_VEHTYPE,GS_cluster_18314684_1833694981,172,180,8
car6.7,DEFAULT_VEHTYPE,GS_cluster_18314684_1833694981,171,180,9
car6.8,DEFAULT_VEHTYPE,GS_cluster_18314684_1833694981,163,180,17
car6.9,DEFAULT_VEHTYPE,GS_cluster_18314684_1833694981,173,180,7
car3.40,DEFAULT_VEHTYPE,122763218,180,181,1
car6.19,DEFAULT_VEHTYPE,122763218,170,181,11
car6.20,DEFAULT_VEHTYPE,122763218,170,181,11
car6.21,DEFAULT_VEHTYPE,122763218,171,181,10
car6.22,DEFAULT_VEHTYPE,122763218,172,181,9
car6.23,DEFAULT_VEHTYPE,122763218,173,181,8
car6.24,DEFAULT_VEHTYPE,122763218,173,181,8
car6.28,DEFAULT_VEHTYPE,122763222,179,182,3
car4.27,DEFAULT_VEHTYPE,123160850,137,184,47
car4.28,DEFAULT_VEHTYPE,123160850,142,185,43
car4.30,DEFAULT_VEHTYPE,123160850,152,185,33
bus2,bus,14963731,165,186,21
car3.41,DEFAULT_VEHTYPE,122763218,185,186,1
car5.2,DEFAULT_VEHTYPE,122574871,175,186,11
car1.33,DEFAULT_VEHTYPE,36635979,163,188,25
car1.34,DEFAULT_VEHTYPE,36635979,167,188,21
car1.35,DEFAULT_VEHTYPE,36635979,172,188,16
car1.36,DEFAULT_VEHTYPE,36635979,175,188,13
car1.37,DEFAULT_VEHTYPE,36635979,181,188,7
car1.38,DEFAULT_VEHTYPE,36635979,184,188,4
car4.0,DEFAULT_VEHTYPE,cluster_123160878_2450046772,187,189,2
car3.42,DEFAULT_VEHTYPE,122763218,189,190,1
car3.21,DEFAULT_VEHTYPE,1686594173,163,191,28
car3.31,DEFAULT_VEHTYPE,122763218,158,192,34
car3.38,DEFAULT_VEHTYPE,122763218,187,193,6
car6.17,DEFAULT_VEHTYPE,122763218,168,195,27
car6.18,DEFAULT_VEHTYPE,122763218,169,195,26
car6.1,DEFAULT_VEHTYPE,16218739,174,196,22
car1.31,DEFAULT_VEHTYPE,36635979,155,197,42
car1.32,DEFAULT_VEHTYPE,36635979,159,197,38
car1.21,DEFAULT_VEHTYPE,36635976,179,198,19
car1.22,DEFAULT_VEHTYPE,36635976,178,198,20
car1.23,DEFAULT_VEHTYPE,36635976,181,198,17
car1.24,DEFAULT_VEHTYPE,36635976,184,198,14
car1.25,DEFAULT_VEHTYPE,36635976,181,198,17
car1.26,DEFAULT_VEHTYPE,36635976,186,198,12
car1.27,DEFAULT_VEHTYPE,36635976,183,198,15
car1.30,DEFAULT_VEHTYPE,36635976,185,198,13
car2.19,DEFAULT_VEHTYPE,cluster_1832615131_4075599903_5942692697_5942692700,158,198,40
car2.20,DEFAULT_VEHTYPE,cluster_1832615131_4075599903_5942692697_5942692700,158,198,40
car2.21,DEFAULT_VEHTYPE,cluster_1832615131_4075599903_5942692697_5942692700,163,198,35
car2.22,DEFAULT_VEHTYPE,cluster_1832615131_4075599903_5942692697_5942692700,159,198,39
car2.23,DEFAULT_VEHTYPE,cluster_1832615131_4075599903_5942692697_5942692700,162,198,36
car2.24,DEFAULT_VEHTYPE,cluster_1832615131_4075599903_5942692697_5942692700,160,198,38
car2.6,DEFAULT_VEHTYPE,36635976,172,198,26
car6.3,DEFAULT_VEHTYPE,GS_cluster_18314684_1833694981,167,198,31
car6.32,DEFAULT_VEHTYPE,122763222,194,198,4
car6.34,DEFAULT_VEHTYPE,122763222,196,198,2
car1.10,DEFAULT_VEHTYPE,122865866,186,199,13
car1.11,DEFAULT_VEHTYPE,122865866,180,199,19
car1.13,DEFAULT_VEHTYPE,122865866,182,199,17
car1.15,DEFAULT_VEHTYPE,122865866,183,199,16
car1.17,DEFAULT_VEHTYPE,122865866,185,199,14
car1.18,DEFAULT_VEHTYPE,122865866,186,199,13
car1.4,DEFAULT_VEHTYPE,122865866,183,199,16
car1.8,DEFAULT_VEHTYPE,122865866,185,199,14
car4.29,DEFAULT_VEHTYPE,123160859,193,200,7
car4.31,DEFAULT_VEHTYPE,123160859,193,200,7
car4.32,DEFAULT_VEHTYPE,123160859,194,200,6
car4.33,DEFAULT_VEHTYPE,123160859,193,200,7
car4.34,DEFAULT_VEHTYPE,123160859,194,200,6
car4.35,DEFAULT_VEHTYPE,123160859,195,200,5
car4.36,DEFAULT_VEHTYPE,123160859,194,200,6
car4.37,DEFAULT_VEHTYPE,123160859,197,200,3
car4.38,DEFAULT_VEHTYPE,123160859,197,200,3
car6.26,DEFAULT_VEHTYPE,122763222,178,200,22
car6.4,DEFAULT_VEHTYPE,GS_cluster_18314684_1833694981,161,200,39
car4.15,DEFAULT_VEHTYPE,123160863,186,201,15
car4.17,DEFAULT_VEHTYPE,123160863,186,201,15
car4.18,DEFAULT_VEHTYPE,123160863,190,201,11
car4.20,DEFAULT_VEHTYPE,123160863,189,201,12
car4.21,DEFAULT_VEHTYPE,123160863,191,201,10
car4.22,DEFAULT_VEHTYPE,123160863,189,201,12
car4.23,DEFAULT_VEHTYPE,123160863,190,201,11
car4.24,DEFAULT_VEHTYPE,123160863,191,201,10
car4.25,DEFAULT_VEHTYPE,123160863,190,201,11
car4.26,DEFAULT_VEHTYPE,123160863,192,201,9
car2.7,DEFAULT_VEHTYPE,11331520849,163,202,39
car5.7,DEFAULT_VEHTYPE,122865866,85,202,117
car2.9,DEFAULT_VEHTYPE,11331520849,167,204,37
car5.0,DEFAULT_VEHTYPE,32581279,162,204,42
car5.2,DEFAULT_VEHTYPE,122574871,189,204,15
car3.7,DEFAULT_VEHTYPE,122830047,181,205,24
car5.1,DEFAULT_VEHTYPE,122574871,173,205,32
car2.29,DEFAULT_VEHTYPE,36635968,162,206,44
car5.9,DEFAULT_VEHTYPE,122865866,139,206,67
car4.27,DEFAULT_VEHTYPE,123160859,191,207,16
car4.28,DEFAULT_VEHTYPE,123160859,191,207,16
car4.30,DEFAULT_VEHTYPE,123160859,190,207,17
car6.13,DEFAULT_VEHTYPE,GS_cluster_18314684_1833694981,201,207,6
car6.16,DEFAULT_VEHTYPE,GS_cluster_18314684_1833694981,203,207,4
car3.46,DEFAULT_VEHTYPE,122763218,207,208,1
car1.19,DEFAULT_VEHTYPE,36635976,178,209,31
car1.20,DEFAULT_VEHTYPE,36635976,177,209,32
car2.28,DEFAULT_VEHTYPE,36635968,157,209,52
car5.7,DEFAULT_VEHTYPE,1686594171,208,210,2
car5.8,DEFAULT_VEHTYPE,1686594171,209,210,1
car6.27,DEFAULT_VEHTYPE,122763218,207,210,3
car6.28,DEFAULT_VEHTYPE,122763218,209,210,1
car3.47,DEFAULT_VEHTYPE,122763218,212,213,1
car2.3,DEFAULT_VEHTYPE,36635976,171,215,44
car2.5,DEFAULT_VEHTYPE,122865866,175,215,40
car6.39,DEFAULT_VEHTYPE,36635979,190,215,25
car6.40,DEFAULT_VEHTYPE,36635979,196,215,19
car6.41,DEFAULT_VEHTYPE,36635979,201,215,14
car6.42,DEFAULT_VEHTYPE,36635979,204,215,11
car6.43,DEFAULT_VEHTYPE,36635979,209,215,6
car6.44,DEFAULT_VEHTYPE,36635979,213,215,2
bus2,bus,122574886,204,216,12
car2.2,DEFAULT_VEHTYPE,36635976,169,216,47
car6.4,DEFAULT_VEHTYPE,122763207,206,216,10
car6.5,DEFAULT_VEHTYPE,122763207,208,216,8
car6.8,DEFAULT_VEHTYPE,122763207,210,216,6
car6.9,DEFAULT_VEHTYPE,122763207,209,216,7
car3.48,DEFAULT_VEHTYPE,122763218,216,217,1
car4.10,DEFAULT_VEHTYPE,122663827,177,217,40
car2.0,DEFAULT_VEHTYPE,36635976,170,218,48
car3.44,DEFAULT_VEHTYPE,122763218,216,218,2
car6.19,DEFAULT_VEHTYPE,GS_cluster_10738391828_178489893,201,218,17
car6.20,DEFAULT_VEHTYPE,GS_cluster_10738391828_178489893,202,218,16
car6.21,DEFAULT_VEHTYPE,GS_cluster_10738391828_178489893,203,218,15
car6.22,DEFAULT_VEHTYPE,GS_cluster_10738391828_178489893,205,218,13
car6.30,DEFAULT_VEHTYPE,122763222,194,218,24
bus4,bus,cluster_123160878_2450046772,204,221,17
car3.37,DEFAULT_VEHTYPE,122763218,185,221,36
car3.49,DEFAULT_VEHTYPE,122763218,221,222,1
car4.14,DEFAULT_VEHTYPE,123160863,185,222,37
car2.4,DEFAULT_VEHTYPE,122865866,174,223,49
car4.11,DEFAULT_VEHTYPE,123160863,184,223,39
car4.19,DEFAULT_VEHTYPE,123160863,186,223,37
car6.3,DEFAULT_VEHTYPE,122763207,204,223,19
car4.16,DEFAULT_VEHTYPE,123160863,186,224,38
car1.5,DEFAULT_VEHTYPE,11331520849,168,225,57
car1.7,DEFAULT_VEHTYPE,11331520849,173,226,53
car2.17,DEFAULT_VEHTYPE,cluster_1832615131_4075599903_5942692697_5942692700,156,226,70
car3.50,DEFAULT_VEHTYPE,122763218,225,226,1
car4.39,DEFAULT_VEHTYPE,123160850,193,226,33
car4.40,DEFAULT_VEHTYPE,123160850,196,226,30
car4.41,DEFAULT_VEHTYPE,123160850,200,226,26
car4.42,DEFAULT_VEHTYPE,123160850,205,226,21
car4.43,DEFAULT_VEHTYPE,123160850,210,226,16
car4.44,DEFAULT_VEHTYPE,123160850,213,226,13
car4.45,DEFAULT_VEHTYPE,123160850,218,226,8
car4.46,DEFAULT_VEHTYPE,123160850,222,226,4
car2.18,DEFAULT_VEHTYPE,cluster_1832615131_4075599903_5942692697_5942692700,155,227,72
car6.38,DEFAULT_VEHTYPE,36635979,187,227,40
car6.25,DEFAULT_VEHTYPE,122763218,204,228,24
car6.26,DEFAULT_VEHTYPE,122763218,207,228,21
car6.37,DEFAULT_VEHTYPE,36635979,183,228,45
car1.9,DEFAULT_VEHTYPE,122865866,177,229,52
car2.43,DEFAULT_VEHTYPE,36635968,226,229,3
car6.17,DEFAULT_VEHTYPE,GS_cluster_10738391828_178489893,199,229,30
car1.6,DEFAULT_VEHTYPE,122865866,176,230,54
bus3,bus,32581279,188,231,43
car3.51,DEFAULT_VEHTYPE,122763218,230,231,1
car4.11,DEFAULT_VEHTYPE,32581278,229,231,2
car4.14,DEFAULT_VEHTYPE,32581278,228,231,3
car4.19,DEFAULT_VEHTYPE,32581278,228,231,3
car6.18,DEFAULT_VEHTYPE,GS_cluster_10738391828_178489893,200,231,31
car6.2,DEFAULT_VEHTYPE,GS_cluster_18314684_1833694981,162,231,69
car3.22,DEFAULT_VEHTYPE,122830043,204,232,28
car3.23,DEFAULT_VEHTYPE,122830043,205,232,27
car3.24,DEFAULT_VEHTYPE,122830043,208,232,24
car3.25,DEFAULT_VEHTYPE,122830043,210,232,22
car3.26,DEFAULT_VEHTYPE,122830043,211,232,21
car3.27,DEFAULT_VEHTYPE,122830043,213,232,19
car3.28,DEFAULT_VEHTYPE,122830043,214,232,18
car3.29,DEFAULT_VEHTYPE,122830043,216,232,16
car3.30,DEFAULT_VEHTYPE,122830043,219,232,13
car3.31,DEFAULT_VEHTYPE,122830043,221,232,11
car3.32,DEFAULT_VEHTYPE,122830043,222,232,10
car3.33,DEFAULT_VEHTYPE,122830043,224,232,8
car3.34,DEFAULT_VEHTYPE,122830043,224,232,8
car3.35,DEFAULT_VEHTYPE,122830043,226,232,6
car3.46,DEFAULT_VEHTYPE,122763218,229,232,3
car3.47,DEFAULT_VEHTYPE,122763218,230,232,2
car1.19,DEFAULT_VEHTYPE,122596361,217,233,16
car1.20,DEFAULT_VEHTYPE,122596361,218,234,16
car6.35,DEFAULT_VEHTYPE,122763222,210,234,24
car2.5,DEFAULT_VEHTYPE,122596361,218,235,17
car1.13,DEFAULT_VEHTYPE,11331520849,235,237,2
car1.15,DEFAULT_VEHTYPE,11331520849,236,237,1
car1.6,DEFAULT_VEHTYPE,11331520849,234,237,3
car1.9,DEFAULT_VEHTYPE,11331520849,232,237,5
car2.17,DEFAULT_VEHTYPE,11331520849,234,237,3
car2.18,DEFAULT_VEHTYPE,11331520849,236,237,1
car2.19,DEFAULT_VEHTYPE,11331520849,236,237,1
car5.0,DEFAULT_VEHTYPE,32581278,209,240,31
car5.10,DEFAULT_VEHTYPE,1686594171,221,240,19
car5.11,DEFAULT_VEHTYPE,1686594171,222,240,18
car5.12,DEFAULT_VEHTYPE,1686594171,225,240,15
car5.16,DEFAULT_VEHTYPE,122865866,182,240,58
car1.19,DEFAULT_VEHTYPE,122865866,239,241,2
car1.20,DEFAULT_VEHTYPE,122865866,240,241,1
car1.21,DEFAULT_VEHTYPE,122865866,240,241,1
car2.15,DEFAULT_VEHTYPE,122865866,228,241,13
car4.3,DEFAULT_VEHTYPE,14963732,237,241,4
car4.4,DEFAULT_VEHTYPE,14963732,239,241,2
car1.45,DEFAULT_VEHTYPE,36635979,216,242,26
car1.46,DEFAULT_VEHTYPE,36635979,223,242,19
car1.47,DEFAULT_VEHTYPE,36635979,225,242,17
car1.48,DEFAULT_VEHTYPE,36635979,231,242,11
car1.49,DEFAULT_VEHTYPE,36635979,235,242,7
car2.39,DEFAULT_VEHTYPE,cluster_1832615131_4075599903_5942692697_5942692700,233,242,9
car2.40,DEFAULT_VEHTYPE,cluster_1832615131_4075599903_5942692697_5942692700,235,242,7
car5.9,DEFAULT_VEHTYPE,1686594171,219,244,25
car6.16,DEFAULT_VEHTYPE,GS_cluster_18314684_1833694981,211,244,33
car2.0,DEFAULT_VEHTYPE,852777135,223,246,23
car2.1,DEFAULT_VEHTYPE,852777135,224,246,22
car2.6,DEFAULT_VEHTYPE,852777135,221,246,25
car1.33,DEFAULT_VEHTYPE,36635976,227,247,20
car1.34,DEFAULT_VEHTYPE,36635976,224,247,23
car1.35,DEFAULT_VEHTYPE,36635976,227,247,20
car1.36,DEFAULT_VEHTYPE,36635976,227,247,20
car1.37,DEFAULT_VEHTYPE,36635976,231,247,16
car1.38,DEFAULT_VEHTYPE,36635976,227,247,20
car1.40,DEFAULT_VEHTYPE,36635976,231,247,16
car1.41,DEFAULT_VEHTYPE,36635976,232,247,15
car2.9,DEFAULT_VEHTYPE,36635976,237,247,10
car3.0,DEFAULT_VEHTYPE,cluster_122688269_4075599865,224,249,25
car3.21,DEFAULT_VEHTYPE,122830043,201,249,48
car5.8,DEFAULT_VEHTYPE,122574871,234,249,15
car6.38,DEFAULT_VEHTYPE,122763222,231,249,18
bus4,bus,2450046769,247,250,3
car4.0,DEFAULT_VEHTYPE,14963731,239,250,11
car4.6,DEFAULT_VEHTYPE,14963731,249,250,1
car4.9,DEFAULT_VEHTYPE,14963731,247,250,3
car1.43,DEFAULT_VEHTYPE,36635979,209,251,42
car3.43,DEFAULT_VEHTYPE,122763218,214,251,37
car6.3,DEFAULT_VEHTYPE,16218739,239,251,12
car1.44,DEFAULT_VEHTYPE,36635979,212,252,40
car5.0,DEFAULT_VEHTYPE,32602629,249,252,3
car3.56,DEFAULT_VEHTYPE,122763218,252,253,1
car2.2,DEFAULT_VEHTYPE,852777135,220,256,36
car2.3,DEFAULT_VEHTYPE,852777135,220,256,36
car2.41,DEFAULT_VEHTYPE,36635968,214,256,42
car2.42,DEFAULT_VEHTYPE,36635968,220,256,36
car1.31,DEFAULT_VEHTYPE,36635976,227,258,31
car1.32,DEFAULT_VEHTYPE,36635976,220,258,38
car3.57,DEFAULT_VEHTYPE,122763218,257,258,1
car3.45,DEFAULT_VEHTYPE,122763218,227,259,32
car4.10,DEFAULT_VEHTYPE,cluster_123160878_2450046772,223,259,36
car6.23,DEFAULT_VEHTYPE,GS_cluster_10738391828_178489893,229,259,30
car6.24,DEFAULT_VEHTYPE,GS_cluster_10738391828_178489893,231,259,28
car6.25,DEFAULT_VEHTYPE,GS_cluster_10738391828_178489893,231,259,28
car6.26,DEFAULT_VEHTYPE,GS_cluster_10738391828_178489893,232,259,27
car6.28,DEFAULT_VEHTYPE,GS_cluster_10738391828_178489893,235,259,24
car4.2,DEFAULT_VEHTYPE,14963732,235,260,25
car6.13,DEFAULT_VEHTYPE,GS_cluster_18314684_1833694981,210,261,51
car3.58,DEFAULT_VEHTYPE,122763218,261,262,1
car4.1,DEFAULT_VEHTYPE,14963732,235,262,27
car4.41,DEFAULT_VEHTYPE,123160863,262,263,1
car6.14,DEFAULT_VEHTYPE,GS_cluster_18314684_1833694981,198,263,65
car2.38,DEFAULT_VEHTYPE,cluster_1832615131_4075599903_5942692697_5942692700,227,264,37
car2.39,DEFAULT_VEHTYPE,cluster_1832615131_4075599903_5942692697_5942692700,247,264,17
car2.40,DEFAULT_VEHTYPE,cluster_1832615131_4075599903_5942692697_5942692700,246,264,18
car2.41,DEFAULT_VEHTYPE,cluster_1832615131_4075599903_5942692697_5942692700,260,264,4
car2.42,DEFAULT_VEHTYPE,cluster_1832615131_4075599903_5942692697_5942692700,261,264,3
car2.44,DEFAULT_VEHTYPE,cluster_1832615131_4075599903_5942692697_5942692700,262,264,2
car2.5,DEFAULT_VEHTYPE,36635976,238,265,27
car2.7,DEFAULT_VEHTYPE,36635976,235,265,30
car6.15,DEFAULT_VEHTYPE,GS_cluster_18314684_1833694981,200,265,65
car5.9,DEFAULT_VEHTYPE,122574871,261,266,5
car3.59,DEFAULT_VEHTYPE,122763218,266,267,1
car4.7,DEFAULT_VEHTYPE,cluster_123160878_2450046772,218,268,50
car5.1,DEFAULT_VEHTYPE,32581279,217,269,52
car5.3,DEFAULT_VEHTYPE,32581279,221,269,48
car5.4,DEFAULT_VEHTYPE,32581279,220,269,49
car5.5,DEFAULT_VEHTYPE,32581279,223,269,46
bus3,bus,122663823,266,270,4
car6.21,DEFAULT_VEHTYPE,GS_cluster_10738391828_178489893,226,270,44
car3.60,DEFAULT_VEHTYPE,122763218,270,271,1
car6.22,DEFAULT_VEHTYPE,GS_cluster_10738391828_178489893,227,271,44
car3.54,DEFAULT_VEHTYPE,122763218,260,272,12
car3.55,DEFAULT_VEHTYPE,122763218,265,272,7
car3.56,DEFAULT_VEHTYPE,122763218,268,272,4
car3.57,DEFAULT_VEHTYPE,122763218,271,272,1
car6.36,DEFAULT_VEHTYPE,122763218,239,272,33
car3.0,DEFAULT_VEHTYPE,cluster_14963716_27976732_3892769467,252,275,23
car4.0,DEFAULT_VEHTYPE,cluster_1687115220_4075599846,274,275,1
car4.9,DEFAULT_VEHTYPE,cluster_1687115220_4075599846,272,275,3
car5.17,DEFAULT_VEHTYPE,122865866,249,275,26
car5.18,DEFAULT_VEHTYPE,122865866,250,275,25
car3.1,DEFAULT_VEHTYPE,cluster_14963716_27976732_3892769467,255,276,21
car2.53,DEFAULT_VEHTYPE,36635968,268,277,9
car2.54,DEFAULT_VEHTYPE,36635968,273,277,4
car6.13,DEFAULT_VEHTYPE,122763207,267,277,10
car6.35,DEFAULT_VEHTYPE,122763218,239,277,38
car3.7,DEFAULT_VEHTYPE,1686594178,227,279,52
car6.3,DEFAULT_VEHTYPE,1927992928,278,279,1
car6.51,DEFAULT_VEHTYPE,36635979,247,279,32
car6.52,DEFAULT_VEHTYPE,36635979,253,279,26
car6.53,DEFAULT_VEHTYPE,36635979,257,279,22
car6.54,DEFAULT_VEHTYPE,36635979,261,279,18
car6.55,DEFAULT_VEHTYPE,36635979,265,279,14
car6.56,DEFAULT_VEHTYPE,36635979,269,279,10
car3.43,DEFAULT_VEHTYPE,1686594173,258,280,22
car5.7,DEFAULT_VEHTYPE,122574871,232,280,48
car3.21,DEFAULT_VEHTYPE,122830047,258,282,24
car5.2,DEFAULT_VEHTYPE,32581279,216,282,66
car5.8,DEFAULT_VEHTYPE,122574871,253,282,29
car2.15,DEFAULT_VEHTYPE,122596361,264,284,20
car3.0,DEFAULT_VEHTYPE,cluster_122688249_4075599864,282,284,2
car3.1,DEFAULT_VEHTYPE,cluster_122688249_4075599864,282,284,2
car4.39,DEFAULT_VEHTYPE,123160863,259,286,27
car4.45,DEFAULT_VEHTYPE,123160863,262,286,24
car4.10,DEFAULT_VEHTYPE,20827734,276,287,11
car4.40,DEFAULT_VEHTYPE,123160863,259,288,29
car3.48,DEFAULT_VEHTYPE,1686594173,278,289,11
car3.49,DEFAULT_VEHTYPE,1686594173,280,289,9
car3.50,DEFAULT_VEHTYPE,1686594173,281,289,8
car3.51,DEFAULT_VEHTYPE,1686594173,284,289,5
car3.52,DEFAULT_VEHTYPE,1686594173,285,289,4
car4.53,DEFAULT_VEHTYPE,123160850,255,290,35
car4.55,DEFAULT_VEHTYPE,123160850,263,290,27
car4.56,DEFAULT_VEHTYPE,123160850,269,290,21
car4.57,DEFAULT_VEHTYPE,123160850,273,290,17
car4.58,DEFAULT_VEHTYPE,123160850,276,290,14
car4.59,DEFAULT_VEHTYPE,123160850,281,290,9
car4.60,DEFAULT_VEHTYPE,123160850,286,290,4
car4.11,DEFAULT_VEHTYPE,cluster_123160878_2450046772,283,291,8
car4.14,DEFAULT_VEHTYPE,cluster_123160878_2450046772,279,291,12
car4.15,DEFAULT_VEHTYPE,cluster_123160878_2450046772,286,291,5
car4.16,DEFAULT_VEHTYPE,cluster_123160878_2450046772,277,291,14
car4.19,DEFAULT_VEHTYPE,cluster_123160878_2450046772,282,291,9
car4.22,DEFAULT_VEHTYPE,cluster_123160878_2450046772,285,291,6
car4.25,DEFAULT_VEHTYPE,cluster_123160878_2450046772,288,291,3
car4.42,DEFAULT_VEHTYPE,123160863,260,291,31
car5.10,DEFAULT_VEHTYPE,123527068,290,291,1
car5.11,DEFAULT_VEHTYPE,123527068,291,292,1
car5.15,DEFAULT_VEHTYPE,122865866,178,292,114
car6.49,DEFAULT_VEHTYPE,36635979,237,292,55
car1.21,DEFAULT_VEHTYPE,11331520849,279,293,14
car1.22,DEFAULT_VEHTYPE,11331520849,282,293,11
car1.23,DEFAULT_VEHTYPE,11331520849,282,293,11
car1.25,DEFAULT_VEHTYPE,11331520849,284,293,9
car6.23,DEFAULT_VEHTYPE,GS_cluster_18314684_1833694981,290,293,3
car6.25,DEFAULT_VEHTYPE,GS_cluster_18314684_1833694981,291,293,2
car6.50,DEFAULT_VEHTYPE,36635979,241,293,52
car6.22,DEFAULT_VEHTYPE,GS_cluster_18314684_1833694981,293,294,1
car4.2,DEFAULT_VEHTYPE,cluster_1687115220_4075599846,285,295,10
car6.13,DEFAULT_VEHTYPE,16218739,291,295,4
car6.14,DEFAULT_VEHTYPE,16218739,291,295,4
car6.15,DEFAULT_VEHTYPE,16218739,294,295,1
car6.24,DEFAULT_VEHTYPE,GS_cluster_18314684_1833694981,294,295,1
car4.1,DEFAULT_VEHTYPE,cluster_1687115220_4075599846,288,296,8
car4.8,DEFAULT_VEHTYPE,cluster_1687115220_4075599846,290,297,7
car6.25,DEFAULT_VEHTYPE,GS_cluster_18314684_1833694981,295,297,2
bus1,bus,cluster_122688269_4075599865,295,298,3
car3.66,DEFAULT_VEHTYPE,122763218,297,298,1
car3.8,DEFAULT_VEHTYPE,cluster_122688269_4075599865,296,298,2
car4.12,DEFAULT_VEHTYPE,cluster_1687115220_4075599846,291,298,7
car3.53,DEFAULT_VEHTYPE,122763218,256,299,43
car4.3,DEFAULT_VEHTYPE,cluster_1687115220_4075599846,292,299,7
bus4,bus,181296152,274,300,26
car4.51,DEFAULT_VEHTYPE,123160850,245,300,55
car4.52,DEFAULT_VEHTYPE,123160850,249,300,51
car4.54,DEFAULT_VEHTYPE,123160850,259,300,41
car5.10,DEFAULT_VEHTYPE,123527068,292,300,8
car5.11,DEFAULT_VEHTYPE,123527068,293,300,7
car5.8,DEFAULT_VEHTYPE,123527068,288,300,12
car5.9,DEFAULT_VEHTYPE,123527068,289,300,11
car1.45,DEFAULT_VEHTYPE,36635976,281,301,20
car1.46,DEFAULT_VEHTYPE,36635976,283,301,18
car1.47,DEFAULT_VEHTYPE,36635976,282,301,19
car1.48,DEFAULT_VEHTYPE,36635976,284,301,17
car1.49,DEFAULT_VEHTYPE,36635976,283,301,18
car1.50,DEFAULT_VEHTYPE,36635976,284,301,17
car1.51,DEFAULT_VEHTYPE,36635976,285,301,16
car1.52,DEFAULT_VEHTYPE,36635976,288,301,13
car4.1,DEFAULT_VEHTYPE,cluster_1687115220_4075599846,301,302,1
car4.41,DEFAULT_VEHTYPE,32581278,298,302,4
car4.42,DEFAULT_VEHTYPE,32581278,297,302,5
car4.43,DEFAULT_VEHTYPE,32581278,299,302,3
car4.44,DEFAULT_VEHTYPE,32581278,298,302,4
car4.46,DEFAULT_VEHTYPE,32581278,296,302,6
car4.47,DEFAULT_VEHTYPE,32581278,300,302,2
car4.48,DEFAULT_VEHTYPE,32581278,295,302,7
car4.49,DEFAULT_VEHTYPE,32581278,298,302,4
car4.50,DEFAULT_VEHTYPE,32581278,295,302,7
car3.67,DEFAULT_VEHTYPE,122763218,302,303,1
car6.28,DEFAULT_VEHTYPE,GS_cluster_18314684_1833694981,301,304,3
car6.31,DEFAULT_VEHTYPE,GS_cluster_18314684_1833694981,303,304,1
car6.36,DEFAULT_VEHTYPE,GS_cluster_18314684_1833694981,298,304,6
bus3,bus,122615428,290,305,15
car6.29,DEFAULT_VEHTYPE,GS_cluster_18314684_1833694981,303,305,2
car1.59,DEFAULT_VEHTYPE,36635979,281,306,25
car1.60,DEFAULT_VEHTYPE,36635979,287,306,19
car1.61,DEFAULT_VEHTYPE,36635979,288,306,18
car1.62,DEFAULT_VEHTYPE,36635979,292,306,14
car1.63,DEFAULT_VEHTYPE,36635979,296,306,10
car1.64,DEFAULT_VEHTYPE,36635979,301,306,5
car2.10,DEFAULT_VEHTYPE,36635979,288,306,18
car2.11,DEFAULT_VEHTYPE,36635979,286,306,20
car2.13,DEFAULT_VEHTYPE,36635979,286,306,20
car2.14,DEFAULT_VEHTYPE,36635979,285,306,21
car2.4,DEFAULT_VEHTYPE,36635979,285,306,21
car2.9,DEFAULT_VEHTYPE,36635979,283,306,23
car3.21,DEFAULT_VEHTYPE,1686594178,304,306,2
car4.7,DEFAULT_VEHTYPE,20827734,274,306,32
car6.27,DEFAULT_VEHTYPE,GS_cluster_18314684_1833694981,305,306,1
car3.64,DEFAULT_VEHTYPE,122763218,305,307,2
car3.68,DEFAULT_VEHTYPE,122763218,306,307,1
car1.11,DEFAULT_VEHTYPE,36635968,302,310,8
car1.6,DEFAULT_VEHTYPE,36635968,299,310,11
car1.9,DEFAULT_VEHTYPE,36635968,296,310,14
car3.25,DEFAULT_VEHTYPE,1686594183,298,310,12
car3.26,DEFAULT_VEHTYPE,1686594183,301,310,9
car3.47,DEFAULT_VEHTYPE,1686594173,276,310,34
car4.8,DEFAULT_VEHTYPE,cluster_1687115220_4075599846,305,310,5
car5.7,DEFAULT_VEHTYPE,123527068,286,310,24
car1.44,DEFAULT_VEHTYPE,36635976,276,312,36
car3.6,DEFAULT_VEHTYPE,cluster_122688249_4075599864,294,312,18
car1.33,DEFAULT_VEHTYPE,122865866,288,313,25
car1.34,DEFAULT_VEHTYPE,122865866,287,313,26
car1.35,DEFAULT_VEHTYPE,122865866,289,313,24
car1.36,DEFAULT_VEHTYPE,122865866,291,313,22
car1.37,DEFAULT_VEHTYPE,122865866,293,313,20
car1.38,DEFAULT_VEHTYPE,122865866,288,313,25
car1.40,DEFAULT_VEHTYPE,122865866,289,313,24
car1.41,DEFAULT_VEHTYPE,122865866,291,313,22
car1.43,DEFAULT_VEHTYPE,36635976,281,313,32
car2.18,DEFAULT_VEHTYPE,122865866,279,313,34
car2.22,DEFAULT_VEHTYPE,122865866,274,313,39
car2.24,DEFAULT_VEHTYPE,122865866,277,313,36
car2.25,DEFAULT_VEHTYPE,122865866,277,313,36
car2.27,DEFAULT_VEHTYPE,122865866,285,313,28
car2.35,DEFAULT_VEHTYPE,122865866,282,313,31
car1.57,DEFAULT_VEHTYPE,36635979,273,315,42
car1.58,DEFAULT_VEHTYPE,36635979,276,315,39
car4.5,DEFAULT_VEHTYPE,cluster_1687115220_4075599846,313,315,2
car6.22,DEFAULT_VEHTYPE,GS_cluster_18314684_1833694981,301,315,14
car6.24,DEFAULT_VEHTYPE,GS_cluster_18314684_1833694981,302,315,13
car6.25,DEFAULT_VEHTYPE,GS_cluster_18314684_1833694981,299,315,16
car6.27,DEFAULT_VEHTYPE,GS_cluster_18314684_1833694981,312,315,3
car6.28,DEFAULT_VEHTYPE,GS_cluster_18314684_1833694981,306,315,9
car6.29,DEFAULT_VEHTYPE,GS_cluster_18314684_1833694981,310,315,5
car6.30,DEFAULT_VEHTYPE,GS_cluster_18314684_1833694981,307,315,8
car6.31,DEFAULT_VEHTYPE,GS_cluster_18314684_1833694981,309,315,6
car6.32,DEFAULT_VEHTYPE,GS_cluster_18314684_1833694981,314,315,1
car6.33,DEFAULT_VEHTYPE,GS_cluster_18314684_1833694981,297,315,18
car6.36,DEFAULT_VEHTYPE,GS_cluster_18314684_1833694981,307,315,8
car4.12,DEFAULT_VEHTYPE,cluster_1687115220_4075599846,309,317,8
car4.13,DEFAULT_VEHTYPE,cluster_1687115220_4075599846,315,317,2
car4.3,DEFAULT_VEHTYPE,cluster_1687115220_4075599846,310,317,7
car4.4,DEFAULT_VEHTYPE,cluster_1687115220_4075599846,311,317,6
car5.1,DEFAULT_VEHTYPE,32602629,315,318,3
car5.4,DEFAULT_VEHTYPE,32602629,317,318,1
car3.53,DEFAULT_VEHTYPE,1686594173,306,319,13
car3.54,DEFAULT_VEHTYPE,1686594173,308,319,11
car3.55,DEFAULT_VEHTYPE,1686594173,309,319,10
car3.56,DEFAULT_VEHTYPE,1686594173,313,319,6
car3.57,DEFAULT_VEHTYPE,1686594173,314,319,5
car2.55,DEFAULT_VEHTYPE,cluster_1832615131_4075599903_5942692697_5942692700,312,320,8
car2.56,DEFAULT_VEHTYPE,cluster_1832615131_4075599903_5942692697_5942692700,314,320,6
car4.22,DEFAULT_VEHTYPE,20827734,315,320,5
car2.15,DEFAULT_VEHTYPE,36635976,287,321,34
car3.7,DEFAULT_VEHTYPE,cluster_122688269_4075599865,288,321,33
car4.37,DEFAULT_VEHTYPE,20827734,320,321,1
car4.53,DEFAULT_VEHTYPE,3769264120,313,321,8
car4.55,DEFAULT_VEHTYPE,3769264120,315,321,6
car4.56,DEFAULT_VEHTYPE,3769264120,316,321,5
car4.57,DEFAULT_VEHTYPE,3769264120,314,321,7
car4.58,DEFAULT_VEHTYPE,3769264120,316,321,5
car4.59,DEFAULT_VEHTYPE,3769264120,318,321,3
car4.60,DEFAULT_VEHTYPE,3769264120,315,321,6
car4.61,DEFAULT_VEHTYPE,3769264120,318,321,3
car4.62,DEFAULT_VEHTYPE,3769264120,319,321,2
car4.63,DEFAULT_VEHTYPE,3769264120,317,321,4
car4.64,DEFAULT_VEHTYPE,3769264120,319,321,2
car6.49,DEFAULT_VEHTYPE,122763218,313,321,8
car6.50,DEFAULT_VEHTYPE,122763218,317,321,4
car6.51,DEFAULT_VEHTYPE,122763218,316,321,5
car6.52,DEFAULT_VEHTYPE,122763218,319,321,2
car1.43,DEFAULT_VEHTYPE,122596361,322,323,1
car1.44,DEFAULT_VEHTYPE,122596361,319,323,4
car4.45,DEFAULT_VEHTYPE,32581278,292,323,31
car6.63,DEFAULT_VEHTYPE,36635979,300,323,23
car6.64,DEFAULT_VEHTYPE,36635979,306,323,17
car6.65,DEFAULT_VEHTYPE,36635979,308,323,15
car6.66,DEFAULT_VEHTYPE,36635979,313,323,10
car6.67,DEFAULT_VEHTYPE,36635979,319,323,4
car6.68,DEFAULT_VEHTYPE,36635979,322,323,1
car4.39,DEFAULT_VEHTYPE,32581278,292,324,32
car1.14,DEFAULT_VEHTYPE,36635968,310,325,15
car1.15,DEFAULT_VEHTYPE,36635968,300,325,25
car1.16,DEFAULT_VEHTYPE,36635968,308,325,17
car1.17,DEFAULT_VEHTYPE,36635968,304,325,21
car1.18,DEFAULT_VEHTYPE,36635968,306,325,19
car2.63,DEFAULT_VEHTYPE,36635968,316,325,9
car2.65,DEFAULT_VEHTYPE,36635968,322,325,3
car3.72,DEFAULT_VEHTYPE,122763218,324,325,1
car4.40,DEFAULT_VEHTYPE,32581278,293,325,32
car3.22,DEFAULT_VEHTYPE,1686594178,307,327,20
car3.23,DEFAULT_VEHTYPE,1686594178,307,327,20
car3.8,DEFAULT_VEHTYPE,cluster_14963716_27976732_3892769467,326,327,1
car5.15,DEFAULT_VEHTYPE,1686594171,298,327,29
car3.2,DEFAULT_VEHTYPE,123416660,325,328,3
car3.24,DEFAULT_VEHTYPE,1686594183,296,329,33
car4.20,DEFAULT_VEHTYPE,20827734,328,329,1
car4.65,DEFAULT_VEHTYPE,123160850,309,329,20
car4.66,DEFAULT_VEHTYPE,123160850,313,329,16
car4.67,DEFAULT_VEHTYPE,123160850,318,329,11
car4.68,DEFAULT_VEHTYPE,123160850,323,329,6
car4.69,DEFAULT_VEHTYPE,123160850,327,329,2
car2.17,DEFAULT_VEHTYPE,122865866,273,330,57
car2.19,DEFAULT_VEHTYPE,122865866,273,330,57
car3.73,DEFAULT_VEHTYPE,122763218,329,330,1
car4.52,DEFAULT_VEHTYPE,3769264120,312,330,18
car4.54,DEFAULT_VEHTYPE,3769264120,311,330,19
car4.51,DEFAULT_VEHTYPE,3769264120,311,331,20
car6.23,DEFAULT_VEHTYPE,GS_cluster_18314684_1833694981,296,331,35
car3.5,DEFAULT_VEHTYPE,cluster_122688249_4075599864,293,332,39
car4.50,DEFAULT_VEHTYPE,122663827,331,332,1
car5.2,DEFAULT_VEHTYPE,32602629,313,332,19
car3.4,DEFAULT_VEHTYPE,cluster_122688249_4075599864,292,333,41
car6.26,DEFAULT_VEHTYPE,GS_cluster_18314684_1833694981,292,333,41
car3.74,DEFAULT_VEHTYPE,122763218,333,334,1
car1.71,DEFAULT_VEHTYPE,36635979,334,335,1
car2.54,DEFAULT_VEHTYPE,cluster_1832615131_4075599903_5942692697_5942692700,309,335,26
car2.55,DEFAULT_VEHTYPE,cluster_1832615131_4075599903_5942692697_5942692700,323,335,12
car2.56,DEFAULT_VEHTYPE,cluster_1832615131_4075599903_5942692697_5942692700,324,335,11
car2.57,DEFAULT_VEHTYPE,cluster_1832615131_4075599903_5942692697_5942692700,327,335,8
car3.52,DEFAULT_VEHTYPE,1686594173,303,336,33
car4.4,DEFAULT_VEHTYPE,cluster_1687115220_4075599846,333,337,4
bus1,bus,122574908,334,338,4
bus3,bus,20827734,320,338,18
car3.63,DEFAULT_VEHTYPE,122763218,301,338,37
car3.75,DEFAULT_VEHTYPE,122763218,338,339,1
car1.32,DEFAULT_VEHTYPE,122865866,286,340,54
car4.10,DEFAULT_VEHTYPE,14963732,316,340,24
car6.21,DEFAULT_VEHTYPE,GS_cluster_18314684_1833694981,287,340,53
car1.31,DEFAULT_VEHTYPE,122865866,285,341,56
car3.4,DEFAULT_VEHTYPE,1686594171,340,342,2
car3.70,DEFAULT_VEHTYPE,122763218,333,342,9
car3.71,DEFAULT_VEHTYPE,122763218,336,342,6
car3.72,DEFAULT_VEHTYPE,122763218,341,342,1
car4.2,DEFAULT_VEHTYPE,cluster_1687115220_4075599846,300,342,42
car4.8,DEFAULT_VEHTYPE,cluster_1687115220_4075599846,313,342,29
car4.26,DEFAULT_VEHTYPE,20827734,342,343,1
car4.28,DEFAULT_VEHTYPE,20827734,339,343,4
car1.69,DEFAULT_VEHTYPE,36635979,326,344,18
car1.70,DEFAULT_VEHTYPE,36635979,330,344,14
car5.10,DEFAULT_VEHTYPE,32581279,321,345,24
car5.11,DEFAULT_VEHTYPE,32581279,323,345,22
car5.8,DEFAULT_VEHTYPE,32581279,317,345,28
car5.9,DEFAULT_VEHTYPE,32581279,319,345,26
car4.1,DEFAULT_VEHTYPE,cluster_1687115220_4075599846,306,347,41
bus2,bus,122574858,344,348,4
car4.6,DEFAULT_VEHTYPE,cluster_1687115220_4075599846,284,349,65
car3.9,DEFAULT_VEHTYPE,cluster_14963716_27976732_3892769467,332,350,18
car4.7,DEFAULT_VEHTYPE,14963731,327,350,23
car2.64,DEFAULT_VEHTYPE,36635968,319,351,32
car1.57,DEFAULT_VEHTYPE,36635976,340,352,12
car1.59,DEFAULT_VEHTYPE,36635976,343,352,9
car1.61,DEFAULT_VEHTYPE,36635976,344,352,8
car1.62,DEFAULT_VEHTYPE,36635976,343,352,9
car1.63,DEFAULT_VEHTYPE,36635976,345,352,7
car1.64,DEFAULT_VEHTYPE,36635976,345,352,7
car1.66,DEFAULT_VEHTYPE,36635976,347,352,5
car1.67,DEFAULT_VEHTYPE,36635976,350,352,2
car2.22,DEFAULT_VEHTYPE,36635976,351,352,1
car2.35,DEFAULT_VEHTYPE,36635976,351,352,1
car1.33,DEFAULT_VEHTYPE,11331520849,348,353,5
car1.34,DEFAULT_VEHTYPE,11331520849,347,353,6
car1.35,DEFAULT_VEHTYPE,11331520849,351,353,2
car1.38,DEFAULT_VEHTYPE,11331520849,349,353,4
car4.53,DEFAULT_VEHTYPE,123160863,340,353,13
car4.55,DEFAULT_VEHTYPE,123160863,338,353,15
car4.56,DEFAULT_VEHTYPE,123160863,341,353,12
car4.58,DEFAULT_VEHTYPE,123160863,340,353,13
car4.59,DEFAULT_VEHTYPE,123160863,341,353,12
car4.60,DEFAULT_VEHTYPE,123160863,339,353,14
car4.61,DEFAULT_VEHTYPE,123160863,342,353,11
car4.63,DEFAULT_VEHTYPE,123160863,342,353,11
car1.69,DEFAULT_VEHTYPE,852777135,351,354,3
car1.70,DEFAULT_VEHTYPE,852777135,352,354,2
car1.71,DEFAULT_VEHTYPE,852777135,352,354,2
car3.44,DEFAULT_VEHTYPE,122830043,292,354,62
car3.45,DEFAULT_VEHTYPE,122830043,293,354,61
car3.46,DEFAULT_VEHTYPE,122830043,294,354,60
car3.47,DEFAULT_VEHTYPE,122830043,320,354,34
car3.48,DEFAULT_VEHTYPE,122830043,322,354,32
car3.49,DEFAULT_VEHTYPE,122830043,323,354,31
car3.50,DEFAULT_VEHTYPE,122830043,324,354,30
car3.51,DEFAULT_VEHTYPE,122830043,326,354,28
car3.52,DEFAULT_VEHTYPE,122830043,341,354,13
car3.53,DEFAULT_VEHTYPE,122830043,344,354,10
car3.54,DEFAULT_VEHTYPE,122830043,347,354,7
car3.55,DEFAULT_VEHTYPE,122830043,349,354,5
car3.56,DEFAULT_VEHTYPE,122830043,351,354,3
car3.57,DEFAULT_VEHTYPE,122830043,353,354,1
car4.1,DEFAULT_VEHTYPE,1686594183,351,354,3
car4.45,DEFAULT_VEHTYPE,122663827,329,354,25
car4.5,DEFAULT_VEHTYPE,1686594183,352,354,2
car4.6,DEFAULT_VEHTYPE,1686594183,353,354,1
car2.62,DEFAULT_VEHTYPE,36635968,312,355,43
car6.65,DEFAULT_VEHTYPE,36635979,324,355,31
car6.66,DEFAULT_VEHTYPE,36635979,324,355,31
car6.67,DEFAULT_VEHTYPE,36635979,324,355,31
car6.68,DEFAULT_VEHTYPE,36635979,324,355,31
car6.69,DEFAULT_VEHTYPE,36635979,325,355,30
car6.70,DEFAULT_VEHTYPE,36635979,332,355,23
car5.7,DEFAULT_VEHTYPE,32581279,316,356,40
car4.39,DEFAULT_VEHTYPE,122663827,331,357,26
car5.14,DEFAULT_VEHTYPE,122574871,282,357,75
car4.36,DEFAULT_VEHTYPE,20827734,353,358,5
car4.65,DEFAULT_VEHTYPE,3769264120,352,358,6
car4.66,DEFAULT_VEHTYPE,3769264120,351,358,7
car4.67,DEFAULT_VEHTYPE,3769264120,355,358,3
car4.69,DEFAULT_VEHTYPE,3769264120,353,358,5
car4.70,DEFAULT_VEHTYPE,3769264120,355,358,3
car4.71,DEFAULT_VEHTYPE,3769264120,353,358,5
car4.72,DEFAULT_VEHTYPE,3769264120,354,358,4
car2.53,DEFAULT_VEHTYPE,cluster_1832615131_4075599903_5942692697_5942692700,308,360,52
car2.59,DEFAULT_VEHTYPE,cluster_1832615131_4075599903_5942692697_5942692700,320,360,40
car5.13,DEFAULT_VEHTYPE,123527068,317,360,43
car1.19,DEFAULT_VEHTYPE,11331520849,278,361,83
car3.5,DEFAULT_VEHTYPE,1686594171,339,361,22
car1.58,DEFAULT_VEHTYPE,36635976,339,362,23
car3.6,DEFAULT_VEHTYPE,1686594171,339,362,23
car5.15,DEFAULT_VEHTYPE,122686666,338,362,24
car1.60,DEFAULT_VEHTYPE,36635976,338,363,25
car1.20,DEFAULT_VEHTYPE,11331520849,280,364,84
car4.11,DEFAULT_VEHTYPE,20827734,312,364,52
car4.14,DEFAULT_VEHTYPE,20827734,310,364,54
car4.15,DEFAULT_VEHTYPE,20827734,316,364,48
car4.17,DEFAULT_VEHTYPE,20827734,336,364,28
car4.18,DEFAULT_VEHTYPE,20827734,334,364,30
car4.20,DEFAULT_VEHTYPE,20827734,333,364,31
car4.21,DEFAULT_VEHTYPE,20827734,353,364,11
car4.24,DEFAULT_VEHTYPE,20827734,337,364,27
car4.25,DEFAULT_VEHTYPE,20827734,320,364,44
car4.26,DEFAULT_VEHTYPE,20827734,347,364,17
car4.27,DEFAULT_VEHTYPE,20827734,330,364,34
car4.28,DEFAULT_VEHTYPE,20827734,346,364,18
car4.34,DEFAULT_VEHTYPE,20827734,354,364,10
car4.36,DEFAULT_VEHTYPE,20827734,360,364,4
car4.37,DEFAULT_VEHTYPE,20827734,327,364,37
car5.7,DEFAULT_VEHTYPE,32581278,361,365,4
car2.62,DEFAULT_VEHTYPE,cluster_1832615131_4075599903_5942692697_5942692700,360,366,6
car2.63,DEFAULT_VEHTYPE,cluster_1832615131_4075599903_5942692697_5942692700,363,366,3
car2.64,DEFAULT_VEHTYPE,cluster_1832615131_4075599903_5942692697_5942692700,355,366,11
car2.65,DEFAULT_VEHTYPE,cluster_1832615131_4075599903_5942692697_5942692700,357,366,9
car2.66,DEFAULT_VEHTYPE,cluster_1832615131_4075599903_5942692697_5942692700,359,366,7
car2.67,DEFAULT_VEHTYPE,cluster_1832615131_4075599903_5942692697_5942692700,361,366,5
car2.68,DEFAULT_VEHTYPE,cluster_1832615131_4075599903_5942692697_5942692700,364,366,2
car2.69,DEFAULT_VEHTYPE,cluster_1832615131_4075599903_5942692697_5942692700,363,366,3
car3.81,DEFAULT_VEHTYPE,122763218,365,366,1
car4.64,DEFAULT_VEHTYPE,3769264120,335,366,31
car4.62,DEFAULT_VEHTYPE,3769264120,334,367,33
car3.69,DEFAULT_VEHTYPE,122763218,328,368,40
car4.68,DEFAULT_VEHTYPE,3769264120,351,368,17
car5.9,DEFAULT_VEHTYPE,32581278,367,368,1
car6.63,DEFAULT_VEHTYPE,36635979,324,368,44
car5.10,DEFAULT_VEHTYPE,32581278,367,369,2
car3.7,DEFAULT_VEHTYPE,cluster_14963716_27976732_3892769467,324,370,46
car3.8,DEFAULT_VEHTYPE,cluster_14963716_27976732_3892769467,331,370,39
car3.82,DEFAULT_VEHTYPE,122763218,369,370,1
car6.50,DEFAULT_VEHTYPE,GS_cluster_10738391828_178489893,343,370,27
car6.52,DEFAULT_VEHTYPE,GS_cluster_10738391828_178489893,343,370,27
car6.54,DEFAULT_VEHTYPE,GS_cluster_10738391828_178489893,345,370,25
car6.56,DEFAULT_VEHTYPE,GS_cluster_10738391828_178489893,346,370,24
car6.58,DEFAULT_VEHTYPE,GS_cluster_10738391828_178489893,349,370,21
car6.64,DEFAULT_VEHTYPE,36635979,324,370,46
car2.17,DEFAULT_VEHTYPE,36635976,349,371,22
car2.19,DEFAULT_VEHTYPE,36635976,349,372,23
car2.24,DEFAULT_VEHTYPE,36635976,347,372,25
car3.1,DEFAULT_VEHTYPE,123416660,336,372,36
bus3,bus,123043134,367,373,6
car3.3,DEFAULT_VEHTYPE,123416660,334,373,39
car4.52,DEFAULT_VEHTYPE,123160863,335,373,38
car5.23,DEFAULT_VEHTYPE,122865866,293,373,80
car4.73,DEFAULT_VEHTYPE,123160859,354,374,20
car4.74,DEFAULT_VEHTYPE,123160859,355,374,19
car1.22,DEFAULT_VEHTYPE,36635968,373,375,2
car1.25,DEFAULT_VEHTYPE,36635968,374,375,1
car2.75,DEFAULT_VEHTYPE,36635968,372,375,3
car2.76,DEFAULT_VEHTYPE,36635968,371,375,4
car4.57,DEFAULT_VEHTYPE,123160863,339,375,36
car3.43,DEFAULT_VEHTYPE,122830043,290,376,86
car4.54,DEFAULT_VEHTYPE,123160863,337,376,39
car3.21,DEFAULT_VEHTYPE,1686594178,307,377,70
car4.51,DEFAULT_VEHTYPE,123160863,336,377,41
car4.8,DEFAULT_VEHTYPE,1686594183,347,378,31
car6.49,DEFAULT_VEHTYPE,GS_cluster_10738391828_178489893,341,381,40
car3.11,DEFAULT_VEHTYPE,cluster_122688249_4075599864,380,382,2
car3.9,DEFAULT_VEHTYPE,cluster_122688249_4075599864,378,382,4
car6.51,DEFAULT_VEHTYPE,GS_cluster_10738391828_178489893,340,382,42
car4.16,DEFAULT_VEHTYPE,20827734,307,383,76
car4.2,DEFAULT_VEHTYPE,1686594183,348,383,35
car4.22,DEFAULT_VEHTYPE,20827734,323,384,61
car1.65,DEFAULT_VEHTYPE,122596361,383,385,2
car1.68,DEFAULT_VEHTYPE,122596361,381,385,4
car4.31,DEFAULT_VEHTYPE,cluster_123160878_2450046772,346,386,40
car4.32,DEFAULT_VEHTYPE,cluster_123160878_2450046772,347,386,39
car4.39,DEFAULT_VEHTYPE,cluster_123160878_2450046772,362,386,24
car4.40,DEFAULT_VEHTYPE,cluster_123160878_2450046772,364,386,22
car4.45,DEFAULT_VEHTYPE,cluster_123160878_2450046772,360,386,26
car4.50,DEFAULT_VEHTYPE,cluster_123160878_2450046772,365,386,21
car1.76,DEFAULT_VEHTYPE,36635979,356,387,31
car1.77,DEFAULT_VEHTYPE,36635979,361,387,26
car1.78,DEFAULT_VEHTYPE,36635979,365,387,22
car1.79,DEFAULT_VEHTYPE,36635979,370,387,17
car1.80,DEFAULT_VEHTYPE,36635979,373,387,14
car1.81,DEFAULT_VEHTYPE,36635979,378,387,9
car4.7,DEFAULT_VEHTYPE,cluster_1687115220_4075599846,356,387,31
car6.26,DEFAULT_VEHTYPE,1927992928,384,387,3
car1.73,DEFAULT_VEHTYPE,852777135,362,388,26
car2.18,DEFAULT_VEHTYPE,852777135,383,388,5
car2.22,DEFAULT_VEHTYPE,852777135,380,388,8
car2.24,DEFAULT_VEHTYPE,852777135,378,388,10
car2.25,DEFAULT_VEHTYPE,852777135,382,388,6
car2.35,DEFAULT_VEHTYPE,852777135,381,388,7
car2.36,DEFAULT_VEHTYPE,852777135,379,388,9
car3.86,DEFAULT_VEHTYPE,122763218,387,388,1
car3.22,DEFAULT_VEHTYPE,cluster_122688269_4075599865,386,389,3
car4.3,DEFAULT_VEHTYPE,cluster_1687115220_4075599846,331,390,59
bus3,bus,123385551,388,392,4
car3.87,DEFAULT_VEHTYPE,122763218,392,393,1
car4.14,DEFAULT_VEHTYPE,14963732,390,393,3
car4.20,DEFAULT_VEHTYPE,14963732,392,393,1
car4.77,DEFAULT_VEHTYPE,123160850,362,393,31
car4.79,DEFAULT_VEHTYPE,123160850,370,393,23
car4.80,DEFAULT_VEHTYPE,123160850,375,393,18
car4.81,DEFAULT_VEHTYPE,123160850,381,393,12
car4.82,DEFAULT_VEHTYPE,123160850,385,393,8
car4.83,DEFAULT_VEHTYPE,123160850,390,393,3
car5.10,DEFAULT_VEHTYPE,32581278,376,394,18
car5.11,DEFAULT_VEHTYPE,32581278,377,394,17
car5.12,DEFAULT_VEHTYPE,32581278,378,394,16
car5.9,DEFAULT_VEHTYPE,32581278,373,394,21
car4.4,DEFAULT_VEHTYPE,cluster_1687115220_4075599846,341,395,54
car1.74,DEFAULT_VEHTYPE,36635979,349,396,47
car1.75,DEFAULT_VEHTYPE,36635979,353,396,43
car4.33,DEFAULT_VEHTYPE,cluster_123160878_2450046772,343,396,53
car3.88,DEFAULT_VEHTYPE,122763218,396,397,1
car3.84,DEFAULT_VEHTYPE,122763218,395,398,3
car4.65,DEFAULT_VEHTYPE,123160863,375,398,23
car4.66,DEFAULT_VEHTYPE,123160863,375,398,23
car4.67,DEFAULT_VEHTYPE,123160863,378,398,20
car4.69,DEFAULT_VEHTYPE,123160863,377,398,21
car4.70,DEFAULT_VEHTYPE,123160863,379,398,19
car4.72,DEFAULT_VEHTYPE,123160863,376,398,22
car2.17,DEFAULT_VEHTYPE,852777135,375,399,24
car2.19,DEFAULT_VEHTYPE,852777135,378,399,21
car6.30,DEFAULT_VEHTYPE,122763204,393,399,6
car6.39,DEFAULT_VEHTYPE,122763207,387,399,12
car1.67,DEFAULT_VEHTYPE,122596361,380,400,20
bus2,bus,122574849,380,401,21
car1.32,DEFAULT_VEHTYPE,11331520849,344,401,57
car6.32,DEFAULT_VEHTYPE,16218739,369,401,32
car6.34,DEFAULT_VEHTYPE,16218739,366,401,35
car6.35,DEFAULT_VEHTYPE,16218739,368,401,33
car6.40,DEFAULT_VEHTYPE,16218739,365,401,36
car6.42,DEFAULT_VEHTYPE,16218739,371,401,30
car6.44,DEFAULT_VEHTYPE,16218739,371,401,30
car2.74,DEFAULT_VEHTYPE,36635968,363,402,39
car3.14,DEFAULT_VEHTYPE,cluster_14963716_27976732_3892769467,372,402,30
car3.78,DEFAULT_VEHTYPE,122763218,366,402,36
car4.75,DEFAULT_VEHTYPE,123160850,354,402,48
car1.31,DEFAULT_VEHTYPE,11331520849,346,403,57
car3.8,DEFAULT_VEHTYPE,cluster_122688249_4075599864,378,403,25
car4.76,DEFAULT_VEHTYPE,123160850,357,403,46
car4.78,DEFAULT_VEHTYPE,123160850,369,403,34
bus1,bus,122707096,374,404,30
car2.73,DEFAULT_VEHTYPE,36635968,362,404,42
car4.19,DEFAULT_VEHTYPE,20827734,312,404,92
car4.73,DEFAULT_VEHTYPE,3769264120,381,404,23
car4.74,DEFAULT_VEHTYPE,3769264120,380,404,24
car3.7,DEFAULT_VEHTYPE,cluster_122688249_4075599864,377,405,28
car1.71,DEFAULT_VEHTYPE,852777135,361,406,45
car1.72,DEFAULT_VEHTYPE,852777135,359,406,47
car6.37,DEFAULT_VEHTYPE,122763207,385,407,22
car3.4,DEFAULT_VEHTYPE,GS_cluster_10738391828_178489893,388,408,20
car3.6,DEFAULT_VEHTYPE,GS_cluster_10738391828_178489893,385,408,23
car4.43,DEFAULT_VEHTYPE,122663827,350,409,59
car5.7,DEFAULT_VEHTYPE,32602629,392,409,17
car4.10,DEFAULT_VEHTYPE,14963731,345,410,65
car4.32,DEFAULT_VEHTYPE,20827734,406,410,4
car4.39,DEFAULT_VEHTYPE,20827734,409,410,1
car1.57,DEFAULT_VEHTYPE,122865866,388,411,23
car1.59,DEFAULT_VEHTYPE,122865866,391,411,20
car1.61,DEFAULT_VEHTYPE,122865866,392,411,19
car1.62,DEFAULT_VEHTYPE,122865866,388,411,23
car1.64,DEFAULT_VEHTYPE,122865866,389,411,22
car1.66,DEFAULT_VEHTYPE,122865866,392,411,19
car1.67,DEFAULT_VEHTYPE,122865866,403,411,8
car1.68,DEFAULT_VEHTYPE,122865866,404,411,7
car2.54,DEFAULT_VEHTYPE,122865866,400,411,11
car2.55,DEFAULT_VEHTYPE,122865866,397,411,14
car2.56,DEFAULT_VEHTYPE,122865866,399,411,12
car2.57,DEFAULT_VEHTYPE,122865866,405,411,6
car2.60,DEFAULT_VEHTYPE,122865866,406,411,5
car2.61,DEFAULT_VEHTYPE,122865866,409,411,2
car4.22,DEFAULT_VEHTYPE,14963732,389,411,22
car4.47,DEFAULT_VEHTYPE,122663827,347,411,64
car6.21,DEFAULT_VEHTYPE,16218739,363,411,48
bus1,bus,122707098,408,412,4
car5.8,DEFAULT_VEHTYPE,32581278,372,412,40
car6.31,DEFAULT_VEHTYPE,16218739,362,412,50
car1.32,DEFAULT_VEHTYPE,36635968,407,413,6
car3.7,DEFAULT_VEHTYPE,1686594171,411,413,2
car3.8,DEFAULT_VEHTYPE,1686594171,409,413,4
car3.9,DEFAULT_VEHTYPE,1686594171,412,413,1
car6.38,DEFAULT_VEHTYPE,GS_cluster_18314684_1833694981,343,414,71
car3.92,DEFAULT_VEHTYPE,122763218,414,415,1
car6.39,DEFAULT_VEHTYPE,122763204,414,415,1
car3.79,DEFAULT_VEHTYPE,1686594173,410,416,6
car3.80,DEFAULT_VEHTYPE,1686594173,412,416,4
car6.69,DEFAULT_VEHTYPE,122763218,404,416,12
car6.70,DEFAULT_VEHTYPE,122763218,405,416,11
car6.71,DEFAULT_VEHTYPE,122763218,407,416,9
car6.72,DEFAULT_VEHTYPE,122763218,408,416,8
car6.73,DEFAULT_VEHTYPE,122763218,408,416,8
car6.74,DEFAULT_VEHTYPE,122763218,409,416,7
car6.75,DEFAULT_VEHTYPE,122763218,410,416,6
car6.76,DEFAULT_VEHTYPE,122763218,412,416,4
car1.63,DEFAULT_VEHTYPE,122596361,381,417,36
car3.21,DEFAULT_VEHTYPE,cluster_122688269_4075599865,385,417,32
car2.62,DEFAULT_VEHTYPE,11331520849,407,418,11
car2.63,DEFAULT_VEHTYPE,11331520849,408,418,10
car2.65,DEFAULT_VEHTYPE,11331520849,401,418,17
car2.67,DEFAULT_VEHTYPE,11331520849,404,418,14
car2.68,DEFAULT_VEHTYPE,11331520849,410,418,8
car2.69,DEFAULT_VEHTYPE,11331520849,406,418,12
car2.70,DEFAULT_VEHTYPE,11331520849,414,418,4
car2.71,DEFAULT_VEHTYPE,11331520849,415,418,3
car2.72,DEFAULT_VEHTYPE,11331520849,416,418,2
car4.16,DEFAULT_VEHTYPE,14963732,386,418,32
car4.71,DEFAULT_VEHTYPE,123160863,375,418,43
car4.20,DEFAULT_VEHTYPE,14963731,417,419,2
car3.13,DEFAULT_VEHTYPE,cluster_14963716_27976732_3892769467,369,420,51
car3.93,DEFAULT_VEHTYPE,122763218,419,420,1
car4.10,DEFAULT_VEHTYPE,cluster_1687115220_4075599846,416,420,4
car4.68,DEFAULT_VEHTYPE,123160863,373,420,47
car1.73,DEFAULT_VEHTYPE,36635976,413,421,8
car1.75,DEFAULT_VEHTYPE,36635976,420,421,1
car3.89,DEFAULT_VEHTYPE,122763218,418,421,3
car5.14,DEFAULT_VEHTYPE,32581279,369,421,52
car5.15,DEFAULT_VEHTYPE,32581279,374,421,47
car3.15,DEFAULT_VEHTYPE,cluster_14963716_27976732_3892769467,375,422,47
car5.16,DEFAULT_VEHTYPE,122865866,246,422,176
car6.37,DEFAULT_VEHTYPE,122763204,412,422,10
car4.62,DEFAULT_VEHTYPE,123160863,372,423,51
car6.30,DEFAULT_VEHTYPE,122763204,404,423,19
car6.38,DEFAULT_VEHTYPE,122763207,419,423,4
car6.51,DEFAULT_VEHTYPE,122763207,420,423,3
car4.64,DEFAULT_VEHTYPE,123160863,372,424,52
car4.1,DEFAULT_VEHTYPE,cluster_1832615131_4075599903_5942692697_5942692700,389,425,36
car4.12,DEFAULT_VEHTYPE,cluster_1832615131_4075599903_5942692697_5942692700,390,425,35
car4.13,DEFAULT_VEHTYPE,cluster_1832615131_4075599903_5942692697_5942692700,388,425,37
car4.2,DEFAULT_VEHTYPE,cluster_1832615131_4075599903_5942692697_5942692700,386,425,39
car4.5,DEFAULT_VEHTYPE,cluster_1832615131_4075599903_5942692697_5942692700,386,425,39
car4.8,DEFAULT_VEHTYPE,cluster_1832615131_4075599903_5942692697_5942692700,381,425,44
car2.53,DEFAULT_VEHTYPE,122865866,392,426,34
car3.83,DEFAULT_VEHTYPE,122763218,391,426,35
car2.59,DEFAULT_VEHTYPE,122865866,397,427,30
car3.34,DEFAULT_VEHTYPE,cluster_122688269_4075599865,422,427,5
car3.35,DEFAULT_VEHTYPE,cluster_122688269_4075599865,426,427,1
car4.41,DEFAULT_VEHTYPE,20827734,423,427,4
car4.42,DEFAULT_VEHTYPE,20827734,419,427,8
car6.64,DEFAULT_VEHTYPE,GS_cluster_10738391828_178489893,410,427,17
car6.66,DEFAULT_VEHTYPE,GS_cluster_10738391828_178489893,410,427,17
car1.34,DEFAULT_VEHTYPE,36635968,411,428,17
car1.38,DEFAULT_VEHTYPE,36635968,414,428,14
car1.40,DEFAULT_VEHTYPE,36635968,419,428,9
car1.41,DEFAULT_VEHTYPE,36635968,421,428,7
car1.44,DEFAULT_VEHTYPE,36635968,423,428,5
car2.87,DEFAULT_VEHTYPE,36635968,423,428,5
car2.88,DEFAULT_VEHTYPE,36635968,426,428,2
car4.49,DEFAULT_VEHTYPE,20827734,425,428,3
car3.95,DEFAULT_VEHTYPE,122763218,428,429,1
car4.28,DEFAULT_VEHTYPE,14963731,424,429,5
car4.44,DEFAULT_VEHTYPE,20827734,426,429,3
car4.11,DEFAULT_VEHTYPE,14963731,428,430,2
car6.49,DEFAULT_VEHTYPE,122763207,416,430,14
car6.73,DEFAULT_VEHTYPE,122763218,426,430,4
car6.74,DEFAULT_VEHTYPE,122763218,425,430,5
car6.75,DEFAULT_VEHTYPE,122763218,429,430,1
car6.76,DEFAULT_VEHTYPE,122763218,428,430,2
car1.71,DEFAULT_VEHTYPE,36635976,411,432,21
car1.72,DEFAULT_VEHTYPE,36635976,411,432,21
car4.77,DEFAULT_VEHTYPE,3769264120,416,432,16
car4.79,DEFAULT_VEHTYPE,3769264120,418,432,14
car4.80,DEFAULT_VEHTYPE,3769264120,416,432,16
car4.81,DEFAULT_VEHTYPE,3769264120,418,432,14
car4.82,DEFAULT_VEHTYPE,3769264120,420,432,12
car4.83,DEFAULT_VEHTYPE,3769264120,421,432,11
car4.84,DEFAULT_VEHTYPE,3769264120,420,432,12
car4.85,DEFAULT_VEHTYPE,3769264120,421,432,11
car4.86,DEFAULT_VEHTYPE,3769264120,422,432,10
car4.87,DEFAULT_VEHTYPE,3769264120,424,432,8
car6.67,DEFAULT_VEHTYPE,122763218,402,432,30
car3.96,DEFAULT_VEHTYPE,122763218,432,433,1
car4.49,DEFAULT_VEHTYPE,20827734,432,433,1
car5.13,DEFAULT_VEHTYPE,32581279,366,433,67
car6.68,DEFAULT_VEHTYPE,122763218,404,433,29
car3.78,DEFAULT_VEHTYPE,1686594173,409,434,25
car5.22,DEFAULT_VEHTYPE,122865866,292,434,142
car4.11,DEFAULT_VEHTYPE,14963731,433,436,3
car1.58,DEFAULT_VEHTYPE,122865866,384,437,53
car1.60,DEFAULT_VEHTYPE,122865866,383,437,54
car6.63,DEFAULT_VEHTYPE,GS_cluster_10738391828_178489893,405,437,32
bus1,bus,122707103,436,438,2
car3.97,DEFAULT_VEHTYPE,122763218,437,438,1
car6.65,DEFAULT_VEHTYPE,GS_cluster_10738391828_178489893,404,438,34
car3.43,DEFAULT_VEHTYPE,1686594178,439,440,1
car4.75,DEFAULT_VEHTYPE,3769264120,413,441,28
car3.98,DEFAULT_VEHTYPE,122763218,441,442,1
car4.76,DEFAULT_VEHTYPE,3769264120,417,442,25
car4.78,DEFAULT_VEHTYPE,3769264120,414,442,28
car2.66,DEFAULT_VEHTYPE,11331520849,403,444,41
car6.72,DEFAULT_VEHTYPE,122763218,423,444,21
car3.22,DEFAULT_VEHTYPE,cluster_14963716_27976732_3892769467,422,445,23
car3.92,DEFAULT_VEHTYPE,122763218,431,445,14
car3.93,DEFAULT_VEHTYPE,122763218,435,445,10
car3.94,DEFAULT_VEHTYPE,122763218,438,445,7
car3.95,DEFAULT_VEHTYPE,122763218,444,445,1
car4.54,DEFAULT_VEHTYPE,20827734,443,445,2
car5.29,DEFAULT_VEHTYPE,122865866,391,445,54
car3.83,DEFAULT_VEHTYPE,1686594173,433,446,13
car3.84,DEFAULT_VEHTYPE,1686594173,434,446,12
car3.85,DEFAULT_VEHTYPE,1686594173,438,446,8
car3.86,DEFAULT_VEHTYPE,1686594173,439,446,7
car3.87,DEFAULT_VEHTYPE,1686594173,442,446,4
car2.64,DEFAULT_VEHTYPE,11331520849,400,447,47
car6.83,DEFAULT_VEHTYPE,36635979,390,449,59
car6.84,DEFAULT_VEHTYPE,36635979,394,449,55
car6.85,DEFAULT_VEHTYPE,36635979,399,449,50
car6.86,DEFAULT_VEHTYPE,36635979,403,449,46
car6.87,DEFAULT_VEHTYPE,36635979,407,449,42
car6.88,DEFAULT_VEHTYPE,36635979,410,449,39
car4.31,DEFAULT_VEHTYPE,20827734,402,450,48
car4.39,DEFAULT_VEHTYPE,20827734,414,450,36
car4.40,DEFAULT_VEHTYPE,20827734,411,450,39
car4.41,DEFAULT_VEHTYPE,20827734,431,450,19
car4.42,DEFAULT_VEHTYPE,20827734,430,450,20
car4.44,DEFAULT_VEHTYPE,20827734,436,450,14
car4.45,DEFAULT_VEHTYPE,20827734,407,450,43
car4.46,DEFAULT_VEHTYPE,20827734,415,450,35
car4.47,DEFAULT_VEHTYPE,20827734,440,450,10
car4.49,DEFAULT_VEHTYPE,20827734,436,450,14
car4.50,DEFAULT_VEHTYPE,20827734,413,450,37
car4.52,DEFAULT_VEHTYPE,20827734,441,450,9
car4.54,DEFAULT_VEHTYPE,20827734,448,450,2
car3.12,DEFAULT_VEHTYPE,1686594171,421,453,32
car3.13,DEFAULT_VEHTYPE,1686594171,441,453,12
car3.14,DEFAULT_VEHTYPE,1686594171,443,453,10
car3.15,DEFAULT_VEHTYPE,1686594171,447,453,6
car3.16,DEFAULT_VEHTYPE,1686594171,423,453,30
car3.17,DEFAULT_VEHTYPE,1686594171,450,453,3
car3.18,DEFAULT_VEHTYPE,1686594171,447,453,6
car3.19,DEFAULT_VEHTYPE,1686594171,448,453,5
car3.20,DEFAULT_VEHTYPE,1686594171,452,453,1
car2.75,DEFAULT_VEHTYPE,cluster_1832615131_4075599903_5942692697_5942692700,410,456,46
car2.76,DEFAULT_VEHTYPE,cluster_1832615131_4075599903_5942692697_5942692700,409,456,47
car2.77,DEFAULT_VEHTYPE,cluster_1832615131_4075599903_5942692697_5942692700,410,456,46
car2.78,DEFAULT_VEHTYPE,cluster_1832615131_4075599903_5942692697_5942692700,413,456,43
car2.79,DEFAULT_VEHTYPE,cluster_1832615131_4075599903_5942692697_5942692700,412,456,44
car2.80,DEFAULT_VEHTYPE,cluster_1832615131_4075599903_5942692697_5942692700,414,456,42
bus2,bus,GS_cluster_18314684_1833694981,405,457,52
car1.93,DEFAULT_VEHTYPE,852777135,446,459,13
car1.94,DEFAULT_VEHTYPE,852777135,450,459,9
car6.65,DEFAULT_VEHTYPE,GS_cluster_18314684_1833694981,457,459,2
car4.11,DEFAULT_VEHTYPE,14963731,437,460,23
car4.14,DEFAULT_VEHTYPE,14963731,426,460,34
car4.15,DEFAULT_VEHTYPE,14963731,435,460,25
car4.16,DEFAULT_VEHTYPE,14963731,425,460,35
car4.17,DEFAULT_VEHTYPE,14963731,435,460,25
car4.24,DEFAULT_VEHTYPE,14963731,422,460,38
car4.26,DEFAULT_VEHTYPE,14963731,437,460,23
car4.37,DEFAULT_VEHTYPE,14963731,433,460,27
car4.90,DEFAULT_VEHTYPE,123160850,421,461,40
car4.92,DEFAULT_VEHTYPE,123160850,431,461,30
car4.93,DEFAULT_VEHTYPE,123160850,434,461,27
car4.94,DEFAULT_VEHTYPE,123160850,438,461,23
car4.95,DEFAULT_VEHTYPE,123160850,443,461,18
car4.96,DEFAULT_VEHTYPE,123160850,446,461,15
car4.97,DEFAULT_VEHTYPE,123160850,453,461,8
car4.98,DEFAULT_VEHTYPE,123160850,456,461,5
car3.23,DEFAULT_VEHTYPE,cluster_14963716_27976732_3892769467,425,463,38
car3.73,DEFAULT_VEHTYPE,122830043,415,463,48
car3.74,DEFAULT_VEHTYPE,122830043,416,463,47
car3.75,DEFAULT_VEHTYPE,122830043,418,463,45
car3.76,DEFAULT_VEHTYPE,122830043,420,463,43
car3.77,DEFAULT_VEHTYPE,122830043,422,463,41
car3.78,DEFAULT_VEHTYPE,122830043,440,463,23
car3.79,DEFAULT_VEHTYPE,122830043,444,463,19
car3.80,DEFAULT_VEHTYPE,122830043,445,463,18
car3.81,DEFAULT_VEHTYPE,122830043,447,463,16
car3.82,DEFAULT_VEHTYPE,1686594173,429,463,34
car6.81,DEFAULT_VEHTYPE,36635979,381,463,82
car3.21,DEFAULT_VEHTYPE,cluster_14963716_27976732_3892769467,420,464,44
car5.17,DEFAULT_VEHTYPE,122574871,453,464,11
car6.82,DEFAULT_VEHTYPE,36635979,386,464,78
car2.86,DEFAULT_VEHTYPE,36635968,420,465,45
car3.70,DEFAULT_VEHTYPE,1686594183,458,466,8
car3.71,DEFAULT_VEHTYPE,1686594183,459,466,7
car6.38,DEFAULT_VEHTYPE,16218739,446,467,21
car6.39,DEFAULT_VEHTYPE,16218739,430,467,37
car6.49,DEFAULT_VEHTYPE,16218739,442,467,25
car6.50,DEFAULT_VEHTYPE,16218739,450,467,17
car6.51,DEFAULT_VEHTYPE,16218739,445,467,22
car6.52,DEFAULT_VEHTYPE,16218739,452,467,15
car4.35,DEFAULT_VEHTYPE,20827734,389,468,79
car6.64,DEFAULT_VEHTYPE,GS_cluster_18314684_1833694981,465,468,3
car6.69,DEFAULT_VEHTYPE,GS_cluster_10738391828_178489893,437,468,31
car6.70,DEFAULT_VEHTYPE,GS_cluster_10738391828_178489893,440,468,28
car6.72,DEFAULT_VEHTYPE,GS_cluster_10738391828_178489893,447,468,21
car6.74,DEFAULT_VEHTYPE,GS_cluster_10738391828_178489893,449,468,19
car2.53,DEFAULT_VEHTYPE,852777135,458,469,11
car3.104,DEFAULT_VEHTYPE,122763218,468,469,1
car2.85,DEFAULT_VEHTYPE,36635968,414,470,56
car4.75,DEFAULT_VEHTYPE,32581278,467,470,3
car4.78,DEFAULT_VEHTYPE,32581278,469,470,1
car4.80,DEFAULT_VEHTYPE,32581278,469,470,1
car3.91,DEFAULT_VEHTYPE,122763218,429,471,42
car4.89,DEFAULT_VEHTYPE,123160850,417,471,54
car4.91,DEFAULT_VEHTYPE,123160850,426,471,45
car4.88,DEFAULT_VEHTYPE,123160850,413,472,59
car3.10,DEFAULT_VEHTYPE,1686594171,419,473,54
car4.33,DEFAULT_VEHTYPE,20827734,401,473,72
car3.105,DEFAULT_VEHTYPE,122763218,473,474,1
car3.11,DEFAULT_VEHTYPE,1686594171,421,474,53
car4.32,DEFAULT_VEHTYPE,20827734,415,475,60
car6.71,DEFAULT_VEHTYPE,122763218,424,476,52
car1.91,DEFAULT_VEHTYPE,852777135,434,477,43
car1.92,DEFAULT_VEHTYPE,852777135,437,477,40
car4.28,DEFAULT_VEHTYPE,14963731,430,477,47
car3.102,DEFAULT_VEHTYPE,122763218,476,478,2
car3.106,DEFAULT_VEHTYPE,122763218,477,478,1
car4.86,DEFAULT_VEHTYPE,3769264120,447,478,31
car6.30,DEFAULT_VEHTYPE,16218739,429,478,49
car6.37,DEFAULT_VEHTYPE,16218739,427,478,51
car2.98,DEFAULT_VEHTYPE,36635968,471,479,8
car2.99,DEFAULT_VEHTYPE,36635968,475,479,4
car3.91,DEFAULT_VEHTYPE,1686594173,477,479,2
car6.72,DEFAULT_VEHTYPE,GS_cluster_10738391828_178489893,476,479,3
car6.74,DEFAULT_VEHTYPE,GS_cluster_10738391828_178489893,477,479,2
car4.56,DEFAULT_VEHTYPE,cluster_123160878_2450046772,443,480,37
car4.58,DEFAULT_VEHTYPE,cluster_123160878_2450046772,445,480,35
car4.59,DEFAULT_VEHTYPE,cluster_123160878_2450046772,442,480,38
car4.68,DEFAULT_VEHTYPE,cluster_123160878_2450046772,463,480,17
car4.71,DEFAULT_VEHTYPE,cluster_123160878_2450046772,455,480,25
car4.72,DEFAULT_VEHTYPE,cluster_123160878_2450046772,461,480,19
car6.67,DEFAULT_VEHTYPE,GS_cluster_10738391828_178489893,435,480,45
car4.22,DEFAULT_VEHTYPE,14963731,415,481,66
car6.68,DEFAULT_VEHTYPE,GS_cluster_10738391828_178489893,439,481,42
car4.10,DEFAULT_VEHTYPE,1686594183,449,482,33
car4.4,DEFAULT_VEHTYPE,1686594183,398,482,84
car6.66,DEFAULT_VEHTYPE,GS_cluster_18314684_1833694981,462,482,20
car1.73,DEFAULT_VEHTYPE,122865866,455,483,28
car1.74,DEFAULT_VEHTYPE,122865866,457,483,26
car1.75,DEFAULT_VEHTYPE,122865866,457,483,26
car1.76,DEFAULT_VEHTYPE,122865866,460,483,23
car1.77,DEFAULT_VEHTYPE,122865866,460,483,23
car1.78,DEFAULT_VEHTYPE,122865866,461,483,22
car1.79,DEFAULT_VEHTYPE,122865866,462,483,21
car1.80,DEFAULT_VEHTYPE,122865866,463,483,20
car2.62,DEFAULT_VEHTYPE,122865866,456,483,27
car2.63,DEFAULT_VEHTYPE,122865866,462,483,21
car2.65,DEFAULT_VEHTYPE,122865866,453,483,30
car2.67,DEFAULT_VEHTYPE,122865866,459,483,24
car2.70,DEFAULT_VEHTYPE,122865866,461,483,22
car2.71,DEFAULT_VEHTYPE,122865866,462,483,21
car2.74,DEFAULT_VEHTYPE,cluster_1832615131_4075599903_5942692697_5942692700,406,483,77
car3.69,DEFAULT_VEHTYPE,1686594183,455,484,29
car2.73,DEFAULT_VEHTYPE,cluster_1832615131_4075599903_5942692697_5942692700,409,485,76
car3.72,DEFAULT_VEHTYPE,122830043,412,485,73
car4.20,DEFAULT_VEHTYPE,14963731,423,485,62
car1.100,DEFAULT_VEHTYPE,36635979,465,486,21
car1.101,DEFAULT_VEHTYPE,36635979,469,486,17
car1.103,DEFAULT_VEHTYPE,36635979,478,486,8
car1.91,DEFAULT_VEHTYPE,36635976,483,486,3
car1.92,DEFAULT_VEHTYPE,36635976,484,486,2
car1.93,DEFAULT_VEHTYPE,36635976,485,486,1
car1.97,DEFAULT_VEHTYPE,36635979,452,486,34
car1.98,DEFAULT_VEHTYPE,36635979,456,486,30
car1.99,DEFAULT_VEHTYPE,36635979,460,486,26
car2.55,DEFAULT_VEHTYPE,36635979,479,486,7
car2.56,DEFAULT_VEHTYPE,36635979,476,486,10
car2.57,DEFAULT_VEHTYPE,36635979,480,486,6
car2.59,DEFAULT_VEHTYPE,36635979,475,486,11
car2.60,DEFAULT_VEHTYPE,36635979,483,486,3
car2.61,DEFAULT_VEHTYPE,36635979,480,486,6
car3.42,DEFAULT_VEHTYPE,cluster_122688269_4075599865,449,488,39
car4.53,DEFAULT_VEHTYPE,cluster_123160878_2450046772,440,490,50
car3.22,DEFAULT_VEHTYPE,1686594171,485,491,6
car1.57,DEFAULT_VEHTYPE,11331520849,446,494,48
car1.58,DEFAULT_VEHTYPE,11331520849,442,494,52
car1.59,DEFAULT_VEHTYPE,11331520849,450,494,44
car1.60,DEFAULT_VEHTYPE,11331520849,441,494,53
car1.62,DEFAULT_VEHTYPE,11331520849,446,494,48
car1.64,DEFAULT_VEHTYPE,11331520849,448,494,46
car2.73,DEFAULT_VEHTYPE,11331520849,493,494,1
car2.74,DEFAULT_VEHTYPE,11331520849,491,494,3
car2.76,DEFAULT_VEHTYPE,11331520849,493,494,1
car1.95,DEFAULT_VEHTYPE,36635979,442,495,53
car1.96,DEFAULT_VEHTYPE,36635979,448,495,47
car3.110,DEFAULT_VEHTYPE,122763218,495,496,1
car6.83,DEFAULT_VEHTYPE,122763218,492,496,4
car6.84,DEFAULT_VEHTYPE,122763218,491,496,5
car6.86,DEFAULT_VEHTYPE,122763218,493,496,3
car6.88,DEFAULT_VEHTYPE,122763218,495,496,1
car1.47,DEFAULT_VEHTYPE,36635968,492,497,5
car1.54,DEFAULT_VEHTYPE,36635968,494,497,3
car6.63,DEFAULT_VEHTYPE,GS_cluster_18314684_1833694981,454,498,44
car2.64,DEFAULT_VEHTYPE,122865866,451,499,48
car2.66,DEFAULT_VEHTYPE,122865866,450,499,49
car4.16,DEFAULT_VEHTYPE,cluster_1687115220_4075599846,497,499,2
car4.17,DEFAULT_VEHTYPE,cluster_1687115220_4075599846,489,499,10
car4.20,DEFAULT_VEHTYPE,cluster_1687115220_4075599846,492,499,7
car4.22,DEFAULT_VEHTYPE,cluster_1687115220_4075599846,488,499,11
car4.26,DEFAULT_VEHTYPE,cluster_1687115220_4075599846,494,499,5
car4.37,DEFAULT_VEHTYPE,cluster_1687115220_4075599846,486,499,13
car3.111,DEFAULT_VEHTYPE,122763218,500,501,1
car4.78,DEFAULT_VEHTYPE,122663827,499,501,2
car4.80,DEFAULT_VEHTYPE,122663827,498,501,3
car6.64,DEFAULT_VEHTYPE,GS_cluster_18314684_1833694981,471,501,30
car4.31,DEFAULT_VEHTYPE,14963731,501,502,1
car4.33,DEFAULT_VEHTYPE,14963731,499,502,3
car4.35,DEFAULT_VEHTYPE,14963731,497,502,5
car6.65,DEFAULT_VEHTYPE,GS_cluster_18314684_1833694981,462,503,41
car6.67,DEFAULT_VEHTYPE,GS_cluster_18314684_1833694981,502,504,2
car6.69,DEFAULT_VEHTYPE,GS_cluster_18314684_1833694981,500,504,4
car2.65,DEFAULT_VEHTYPE,122596361,504,505,1
car3.112,DEFAULT_VEHTYPE,122763218,504,505,1
car3.20,DEFAULT_VEHTYPE,GS_cluster_10738391828_178489893,504,505,1
car4.32,DEFAULT_VEHTYPE,14963731,504,505,1
car3.101,DEFAULT_VEHTYPE,122763218,473,506,33
car4.45,DEFAULT_VEHTYPE,14963731,505,506,1
car3.18,DEFAULT_VEHTYPE,GS_cluster_10738391828_178489893,499,507,8
car5.16,DEFAULT_VEHTYPE,122574871,452,509,57
car3.113,DEFAULT_VEHTYPE,122763218,509,510,1
car3.23,DEFAULT_VEHTYPE,1686594171,484,510,26
car5.17,DEFAULT_VEHTYPE,122574871,469,510,41
car6.81,DEFAULT_VEHTYPE,122763218,490,510,20
car1.72,DEFAULT_VEHTYPE,122865866,453,511,58
car3.11,DEFAULT_VEHTYPE,GS_cluster_10738391828_178489893,496,511,15
car3.12,DEFAULT_VEHTYPE,GS_cluster_10738391828_178489893,497,511,14
car3.13,DEFAULT_VEHTYPE,GS_cluster_10738391828_178489893,510,511,1
car1.46,DEFAULT_VEHTYPE,36635968,493,512,19
car1.48,DEFAULT_VEHTYPE,36635968,495,512,17
car1.50,DEFAULT_VEHTYPE,36635968,492,512,20
car1.51,DEFAULT_VEHTYPE,36635968,498,512,14
car1.52,DEFAULT_VEHTYPE,36635968,500,512,12
car1.71,DEFAULT_VEHTYPE,122865866,454,512,58
car2.105,DEFAULT_VEHTYPE,36635968,502,512,10
car2.106,DEFAULT_VEHTYPE,36635968,506,512,6
car3.21,DEFAULT_VEHTYPE,1686594171,484,512,28
car6.82,DEFAULT_VEHTYPE,122763218,489,512,23
car2.58,DEFAULT_VEHTYPE,852777135,476,513,37
car3.114,DEFAULT_VEHTYPE,122763218,513,514,1
car4.68,DEFAULT_VEHTYPE,20827734,507,514,7
car4.69,DEFAULT_VEHTYPE,20827734,510,514,4
car4.86,DEFAULT_VEHTYPE,123160863,484,514,30
car4.66,DEFAULT_VEHTYPE,20827734,514,515,1
car6.105,DEFAULT_VEHTYPE,36635979,489,517,28
car6.106,DEFAULT_VEHTYPE,36635979,493,517,24
car6.107,DEFAULT_VEHTYPE,36635979,499,517,18
car6.108,DEFAULT_VEHTYPE,36635979,502,517,15
car6.109,DEFAULT_VEHTYPE,36635979,507,517,10
car6.110,DEFAULT_VEHTYPE,36635979,512,517,5
car1.95,DEFAULT_VEHTYPE,852777135,501,518,17
car3.115,DEFAULT_VEHTYPE,122763218,518,519,1
car4.42,DEFAULT_VEHTYPE,14963731,516,519,3
car5.28,DEFAULT_VEHTYPE,122865866,388,519,131
car3.102,DEFAULT_VEHTYPE,1686594173,515,520,5
car3.103,DEFAULT_VEHTYPE,1686594173,516,520,4
car3.104,DEFAULT_VEHTYPE,1686594173,518,520,2
car2.64,DEFAULT_VEHTYPE,122596361,503,521,18
car4.66,DEFAULT_VEHTYPE,20827734,520,521,1
car2.66,DEFAULT_VEHTYPE,122596361,502,523,21
car3.116,DEFAULT_VEHTYPE,122763218,522,523,1
car4.42,DEFAULT_VEHTYPE,14963731,523,524,1
car5.35,DEFAULT_VEHTYPE,122865866,464,524,60
car1.95,DEFAULT_VEHTYPE,36635976,523,525,2
car4.44,DEFAULT_VEHTYPE,14963732,522,525,3
car3.108,DEFAULT_VEHTYPE,122763218,501,526,25
car3.109,DEFAULT_VEHTYPE,122763218,507,526,19
car3.110,DEFAULT_VEHTYPE,122763218,511,526,15
car3.111,DEFAULT_VEHTYPE,122763218,516,526,10
car3.112,DEFAULT_VEHTYPE,122763218,520,526,6
car3.113,DEFAULT_VEHTYPE,122763218,523,526,3
car4.105,DEFAULT_VEHTYPE,123160850,488,526,38
car4.107,DEFAULT_VEHTYPE,123160850,497,526,29
car4.108,DEFAULT_VEHTYPE,123160850,502,526,24
car4.109,DEFAULT_VEHTYPE,123160850,508,526,18
car4.110,DEFAULT_VEHTYPE,123160850,510,526,16
car4.111,DEFAULT_VEHTYPE,123160850,515,526,11
car4.112,DEFAULT_VEHTYPE,123160850,522,526,4
car4.113,DEFAULT_VEHTYPE,123160850,524,526,2
car4.42,DEFAULT_VEHTYPE,14963731,525,526,1
car3.47,DEFAULT_VEHTYPE,cluster_122688269_4075599865,525,527,2
car3.48,DEFAULT_VEHTYPE,cluster_122688269_4075599865,526,527,1
car3.49,DEFAULT_VEHTYPE,cluster_122688269_4075599865,525,527,2
car6.63,DEFAULT_VEHTYPE,16218739,519,528,9
car6.64,DEFAULT_VEHTYPE,16218739,523,528,5
car6.65,DEFAULT_VEHTYPE,16218739,524,528,4
car6.66,DEFAULT_VEHTYPE,16218739,527,528,1
car4.40,DEFAULT_VEHTYPE,14963731,524,530,6
car6.103,DEFAULT_VEHTYPE,36635979,479,530,51
car6.83,DEFAULT_VEHTYPE,GS_cluster_10738391828_178489893,519,530,11
car6.84,DEFAULT_VEHTYPE,GS_cluster_10738391828_178489893,518,530,12
car6.85,DEFAULT_VEHTYPE,GS_cluster_10738391828_178489893,520,530,10
car6.86,DEFAULT_VEHTYPE,GS_cluster_10738391828_178489893,519,530,11
car6.87,DEFAULT_VEHTYPE,GS_cluster_10738391828_178489893,521,530,9
car6.88,DEFAULT_VEHTYPE,GS_cluster_10738391828_178489893,521,530,9
car6.104,DEFAULT_VEHTYPE,36635979,486,531,45
car2.100,DEFAULT_VEHTYPE,cluster_1832615131_4075599903_5942692697_5942692700,516,532,16
car2.101,DEFAULT_VEHTYPE,cluster_1832615131_4075599903_5942692697_5942692700,515,532,17
car2.102,DEFAULT_VEHTYPE,cluster_1832615131_4075599903_5942692697_5942692700,517,532,15
car2.98,DEFAULT_VEHTYPE,cluster_1832615131_4075599903_5942692697_5942692700,514,532,18
car2.99,DEFAULT_VEHTYPE,cluster_1832615131_4075599903_5942692697_5942692700,510,532,22
car4.88,DEFAULT_VEHTYPE,122663827,530,532,2
car3.42,DEFAULT_VEHTYPE,cluster_14963716_27976732_3892769467,492,533,41
car4.103,DEFAULT_VEHTYPE,123160850,481,535,54
car4.60,DEFAULT_VEHTYPE,14963731,534,535,1
car1.93,DEFAULT_VEHTYPE,36635976,505,536,31
car4.104,DEFAULT_VEHTYPE,123160850,485,536,51
car4.106,DEFAULT_VEHTYPE,123160850,492,536,44
car1.94,DEFAULT_VEHTYPE,36635976,493,537,44
car2.104,DEFAULT_VEHTYPE,36635968,496,538,42
car4.40,DEFAULT_VEHTYPE,14963731,533,538,5
car3.101,DEFAULT_VEHTYPE,1686594173,511,539,28
car2.103,DEFAULT_VEHTYPE,36635968,497,541,44
car4.53,DEFAULT_VEHTYPE,20827734,496,541,45
car4.56,DEFAULT_VEHTYPE,20827734,499,541,42
car4.58,DEFAULT_VEHTYPE,20827734,502,541,39
car4.59,DEFAULT_VEHTYPE,20827734,498,541,43
car4.62,DEFAULT_VEHTYPE,20827734,524,541,17
car4.64,DEFAULT_VEHTYPE,20827734,531,541,10
car4.66,DEFAULT_VEHTYPE,20827734,525,541,16
car4.68,DEFAULT_VEHTYPE,20827734,518,541,23
car4.69,DEFAULT_VEHTYPE,20827734,517,541,24
car4.71,DEFAULT_VEHTYPE,20827734,503,541,38
car4.72,DEFAULT_VEHTYPE,20827734,504,541,37
car4.73,DEFAULT_VEHTYPE,20827734,526,541,15
car4.60,DEFAULT_VEHTYPE,14963731,537,542,5
car6.81,DEFAULT_VEHTYPE,GS_cluster_10738391828_178489893,516,542,26
car6.82,DEFAULT_VEHTYPE,GS_cluster_10738391828_178489893,516,543,27
car2.64,DEFAULT_VEHTYPE,36635976,524,544,20
car1.112,DEFAULT_VEHTYPE,36635979,518,545,27
car1.113,DEFAULT_VEHTYPE,36635979,524,545,21
car1.114,DEFAULT_VEHTYPE,36635979,528,545,17
car1.115,DEFAULT_VEHTYPE,36635979,534,545,11
car1.116,DEFAULT_VEHTYPE,36635979,536,545,9
car1.117,DEFAULT_VEHTYPE,36635979,541,545,4
car3.26,DEFAULT_VEHTYPE,GS_cluster_10738391828_178489893,543,546,3
car3.100,DEFAULT_VEHTYPE,122830043,524,547,23
car3.101,DEFAULT_VEHTYPE,122830043,546,547,1
car3.93,DEFAULT_VEHTYPE,122830043,513,547,34
car3.94,DEFAULT_VEHTYPE,122830043,514,547,33
car3.95,DEFAULT_VEHTYPE,122830043,515,547,32
car3.96,DEFAULT_VEHTYPE,122830043,517,547,30
car3.97,DEFAULT_VEHTYPE,122830043,519,547,28
car3.98,DEFAULT_VEHTYPE,122830043,521,547,26
car3.99,DEFAULT_VEHTYPE,122830043,523,547,24
car5.40,DEFAULT_VEHTYPE,122865866,542,547,5
car5.41,DEFAULT_VEHTYPE,122865866,543,547,4
car4.39,DEFAULT_VEHTYPE,14963731,546,548,2
car5.34,DEFAULT_VEHTYPE,122865866,463,550,87
car2.65,DEFAULT_VEHTYPE,852777135,550,551,1
car2.67,DEFAULT_VEHTYPE,852777135,549,551,2
car6.82,DEFAULT_VEHTYPE,GS_cluster_122686655_1833694983,550,552,2
car4.105,DEFAULT_VEHTYPE,3769264120,549,553,4
car4.107,DEFAULT_VEHTYPE,3769264120,550,553,3
car4.108,DEFAULT_VEHTYPE,3769264120,552,553,1
car4.109,DEFAULT_VEHTYPE,3769264120,550,553,3
car4.110,DEFAULT_VEHTYPE,3769264120,552,553,1
car4.112,DEFAULT_VEHTYPE,3769264120,551,553,2
car4.28,DEFAULT_VEHTYPE,cluster_1687115220_4075599846,483,553,70
car6.73,DEFAULT_VEHTYPE,122763204,544,553,9
car1.111,DEFAULT_VEHTYPE,36635979,515,554,39
car4.98,DEFAULT_VEHTYPE,123160863,501,554,53
car6.68,DEFAULT_VEHTYPE,122763204,542,554,12
car1.110,DEFAULT_VEHTYPE,36635979,511,555,44
car3.107,DEFAULT_VEHTYPE,122763218,498,555,57
car3.123,DEFAULT_VEHTYPE,122763218,554,555,1
car6.85,DEFAULT_VEHTYPE,GS_cluster_122686655_1833694983,554,555,1
car3.22,DEFAULT_VEHTYPE,GS_cluster_10738391828_178489893,540,556,16
car3.25,DEFAULT_VEHTYPE,GS_cluster_10738391828_178489893,553,556,3
car3.26,DEFAULT_VEHTYPE,GS_cluster_10738391828_178489893,549,556,7
car3.29,DEFAULT_VEHTYPE,GS_cluster_10738391828_178489893,547,556,9
car3.31,DEFAULT_VEHTYPE,GS_cluster_10738391828_178489893,550,556,6
car3.34,DEFAULT_VEHTYPE,GS_cluster_10738391828_178489893,550,556,6
car3.36,DEFAULT_VEHTYPE,GS_cluster_10738391828_178489893,553,556,3
car4.95,DEFAULT_VEHTYPE,123160863,500,556,56
car2.97,DEFAULT_VEHTYPE,cluster_1832615131_4075599903_5942692697_5942692700,491,557,66
car4.75,DEFAULT_VEHTYPE,cluster_123160878_2450046772,533,557,24
car4.76,DEFAULT_VEHTYPE,cluster_123160878_2450046772,536,557,21
car4.78,DEFAULT_VEHTYPE,cluster_123160878_2450046772,538,557,19
car4.79,DEFAULT_VEHTYPE,cluster_123160878_2450046772,527,557,30
car4.80,DEFAULT_VEHTYPE,cluster_123160878_2450046772,532,557,25
car4.87,DEFAULT_VEHTYPE,cluster_123160878_2450046772,529,557,28
car6.116,DEFAULT_VEHTYPE,36635979,539,557,18
car6.117,DEFAULT_VEHTYPE,36635979,543,557,14
car6.118,DEFAULT_VEHTYPE,36635979,548,557,9
car6.119,DEFAULT_VEHTYPE,36635979,554,557,3
car6.120,DEFAULT_VEHTYPE,36635979,556,557,1
car3.124,DEFAULT_VEHTYPE,122763218,558,559,1
car4.39,DEFAULT_VEHTYPE,14963731,550,559,9
car4.40,DEFAULT_VEHTYPE,14963731,542,559,17
car4.42,DEFAULT_VEHTYPE,14963731,528,559,31
car4.45,DEFAULT_VEHTYPE,14963731,513,559,46
car4.49,DEFAULT_VEHTYPE,14963731,515,559,44
car4.52,DEFAULT_VEHTYPE,20827734,471,559,88
car4.60,DEFAULT_VEHTYPE,14963731,546,559,13
car4.11,DEFAULT_VEHTYPE,cluster_1687115220_4075599846,534,560,26
car4.27,DEFAULT_VEHTYPE,cluster_1687115220_4075599846,537,560,23
car4.30,DEFAULT_VEHTYPE,cluster_1687115220_4075599846,535,560,25
car2.117,DEFAULT_VEHTYPE,36635968,558,561,3
car2.64,DEFAULT_VEHTYPE,852777135,549,561,12
car2.96,DEFAULT_VEHTYPE,cluster_1832615131_4075599903_5942692697_5942692700,489,561,72
car3.44,DEFAULT_VEHTYPE,cluster_14963716_27976732_3892769467,535,561,26
car3.46,DEFAULT_VEHTYPE,cluster_14963716_27976732_3892769467,537,561,24
car3.47,DEFAULT_VEHTYPE,cluster_14963716_27976732_3892769467,554,561,7
car4.106,DEFAULT_VEHTYPE,3769264120,548,561,13
car4.23,DEFAULT_VEHTYPE,cluster_1687115220_4075599846,536,561,25
car1.93,DEFAULT_VEHTYPE,122596361,545,562,17
car2.71,DEFAULT_VEHTYPE,852777135,547,562,15
car4.103,DEFAULT_VEHTYPE,3769264120,546,562,16
car4.104,DEFAULT_VEHTYPE,3769264120,549,562,13
car4.55,DEFAULT_VEHTYPE,20827734,473,563,90
car1.94,DEFAULT_VEHTYPE,122596361,546,564,18
car3.125,DEFAULT_VEHTYPE,122763218,563,564,1
car3.92,DEFAULT_VEHTYPE,122830043,510,566,56
car6.83,DEFAULT_VEHTYPE,GS_cluster_122686655_1833694983,553,566,13
car4.67,DEFAULT_VEHTYPE,cluster_123160878_2450046772,515,567,52
car5.29,DEFAULT_VEHTYPE,122574871,551,567,16
car3.106,DEFAULT_VEHTYPE,1686594173,535,568,33
car3.126,DEFAULT_VEHTYPE,122763218,567,568,1
car4.18,DEFAULT_VEHTYPE,cluster_1687115220_4075599846,534,570,36
car4.19,DEFAULT_VEHTYPE,cluster_1687115220_4075599846,568,570,2
car4.23,DEFAULT_VEHTYPE,cluster_1687115220_4075599846,567,570,3
car4.27,DEFAULT_VEHTYPE,cluster_1687115220_4075599846,567,570,3
car4.30,DEFAULT_VEHTYPE,cluster_1687115220_4075599846,565,570,5
car6.81,DEFAULT_VEHTYPE,GS_cluster_122686655_1833694983,549,571,22
car3.127,DEFAULT_VEHTYPE,122763218,572,573,1
car3.45,DEFAULT_VEHTYPE,cluster_122688249_4075599864,543,573,30
car3.121,DEFAULT_VEHTYPE,122763218,562,574,12
car3.122,DEFAULT_VEHTYPE,122763218,565,574,9
car3.123,DEFAULT_VEHTYPE,122763218,569,574,5
car3.124,DEFAULT_VEHTYPE,122763218,573,574,1
car3.71,DEFAULT_VEHTYPE,1686594178,497,574,77
car4.66,DEFAULT_VEHTYPE,14963732,571,574,3
car4.68,DEFAULT_VEHTYPE,14963732,573,574,1
car3.42,DEFAULT_VEHTYPE,cluster_122688249_4075599864,540,575,35
car6.67,DEFAULT_VEHTYPE,16218739,560,575,15
car6.68,DEFAULT_VEHTYPE,16218739,561,575,14
car6.69,DEFAULT_VEHTYPE,16218739,562,575,13
car6.70,DEFAULT_VEHTYPE,16218739,563,575,12
car6.72,DEFAULT_VEHTYPE,16218739,563,575,12
car6.73,DEFAULT_VEHTYPE,16218739,558,575,17
car6.90,DEFAULT_VEHTYPE,GS_cluster_10738391828_178489893,546,576,30
car6.92,DEFAULT_VEHTYPE,GS_cluster_10738391828_178489893,547,576,29
car6.93,DEFAULT_VEHTYPE,GS_cluster_10738391828_178489893,548,576,28
car6.95,DEFAULT_VEHTYPE,GS_cluster_10738391828_178489893,549,576,27
car6.97,DEFAULT_VEHTYPE,GS_cluster_10738391828_178489893,552,576,24
car3.64,DEFAULT_VEHTYPE,cluster_122688269_4075599865,568,577,9
car3.65,DEFAULT_VEHTYPE,cluster_122688269_4075599865,569,577,8
car4.82,DEFAULT_VEHTYPE,122663827,514,577,63
car3.66,DEFAULT_VEHTYPE,cluster_122688269_4075599865,571,578,7
car4.105,DEFAULT_VEHTYPE,123160863,571,578,7
car4.107,DEFAULT_VEHTYPE,123160863,569,578,9
car4.108,DEFAULT_VEHTYPE,123160863,573,578,5
car4.110,DEFAULT_VEHTYPE,123160863,571,578,7
car4.111,DEFAULT_VEHTYPE,123160863,574,578,4
car4.112,DEFAULT_VEHTYPE,123160863,570,578,8
car4.113,DEFAULT_VEHTYPE,123160863,572,578,6
car4.115,DEFAULT_VEHTYPE,123160863,574,578,4
car3.67,DEFAULT_VEHTYPE,cluster_122688269_4075599865,572,579,7
car4.94,DEFAULT_VEHTYPE,122663827,529,579,50
car3.110,DEFAULT_VEHTYPE,1686594173,569,580,11
car3.111,DEFAULT_VEHTYPE,1686594173,572,580,8
car3.112,DEFAULT_VEHTYPE,1686594173,575,580,5
car3.113,DEFAULT_VEHTYPE,1686594173,576,580,4
car3.114,DEFAULT_VEHTYPE,1686594173,579,580,1
car3.68,DEFAULT_VEHTYPE,cluster_122688269_4075599865,575,580,5
car3.69,DEFAULT_VEHTYPE,cluster_122688269_4075599865,577,580,3
car3.70,DEFAULT_VEHTYPE,cluster_122688269_4075599865,578,580,2
car4.118,DEFAULT_VEHTYPE,123160850,547,580,33
car4.120,DEFAULT_VEHTYPE,123160850,554,580,26
car4.121,DEFAULT_VEHTYPE,123160850,560,580,20
car4.122,DEFAULT_VEHTYPE,123160850,564,580,16
car4.123,DEFAULT_VEHTYPE,123160850,569,580,11
car4.124,DEFAULT_VEHTYPE,123160850,573,580,7
car4.125,DEFAULT_VEHTYPE,123160850,579,580,1
car1.100,DEFAULT_VEHTYPE,122865866,575,581,6
car1.93,DEFAULT_VEHTYPE,122865866,566,581,15
car1.94,DEFAULT_VEHTYPE,122865866,570,581,11
car1.95,DEFAULT_VEHTYPE,122865866,569,581,12
car1.96,DEFAULT_VEHTYPE,122865866,573,581,8
car1.97,DEFAULT_VEHTYPE,122865866,570,581,11
car1.98,DEFAULT_VEHTYPE,122865866,573,581,8
car1.99,DEFAULT_VEHTYPE,122865866,572,581,9
car2.73,DEFAULT_VEHTYPE,122865866,532,581,49
car2.75,DEFAULT_VEHTYPE,122865866,536,581,45
car2.76,DEFAULT_VEHTYPE,122865866,535,581,46
car2.77,DEFAULT_VEHTYPE,122865866,538,581,43
car2.78,DEFAULT_VEHTYPE,122865866,541,581,40
car2.81,DEFAULT_VEHTYPE,122865866,533,581,48
car4.61,DEFAULT_VEHTYPE,14963731,513,581,68
car4.81,DEFAULT_VEHTYPE,122663827,515,581,66
car6.84,DEFAULT_VEHTYPE,GS_cluster_18314684_1833694981,580,581,1
car6.85,DEFAULT_VEHTYPE,GS_cluster_18314684_1833694981,577,581,4
car4.98,DEFAULT_VEHTYPE,32581278,559,582,23
car4.29,DEFAULT_VEHTYPE,1686594183,555,583,28
car6.66,DEFAULT_VEHTYPE,16218739,534,585,51
car6.81,DEFAULT_VEHTYPE,GS_cluster_18314684_1833694981,583,585,2
car6.86,DEFAULT_VEHTYPE,GS_cluster_18314684_1833694981,573,585,12
car1.123,DEFAULT_VEHTYPE,36635979,568,586,18
car1.124,DEFAULT_VEHTYPE,36635979,573,586,13
car1.125,DEFAULT_VEHTYPE,36635979,578,586,8
car1.126,DEFAULT_VEHTYPE,36635979,581,586,5
car1.127,DEFAULT_VEHTYPE,36635979,585,586,1
car2.62,DEFAULT_VEHTYPE,36635979,569,586,17
car2.63,DEFAULT_VEHTYPE,36635979,571,586,15
car2.65,DEFAULT_VEHTYPE,36635979,570,586,16
car2.66,DEFAULT_VEHTYPE,36635979,567,586,19
car2.67,DEFAULT_VEHTYPE,36635979,568,586,18
car2.70,DEFAULT_VEHTYPE,36635979,571,586,15
car6.64,DEFAULT_VEHTYPE,16218739,534,586,52
car2.115,DEFAULT_VEHTYPE,36635968,546,587,41
car4.76,DEFAULT_VEHTYPE,20827734,583,587,4
car6.89,DEFAULT_VEHTYPE,GS_cluster_10738391828_178489893,543,587,44
car2.116,DEFAULT_VEHTYPE,36635968,552,588,36
car4.54,DEFAULT_VEHTYPE,14963731,587,588,1
car4.78,DEFAULT_VEHTYPE,20827734,587,588,1
car6.91,DEFAULT_VEHTYPE,GS_cluster_10738391828_178489893,547,588,41
car4.48,DEFAULT_VEHTYPE,14963731,587,589,2
car4.51,DEFAULT_VEHTYPE,20827734,474,589,115
car5.28,DEFAULT_VEHTYPE,122574871,548,589,41
car4.114,DEFAULT_VEHTYPE,123160850,539,590,51
car4.117,DEFAULT_VEHTYPE,123160850,544,590,46
car4.119,DEFAULT_VEHTYPE,123160850,551,590,39
car4.57,DEFAULT_VEHTYPE,14963731,588,590,2
car6.103,DEFAULT_VEHTYPE,122763218,552,590,38
car1.111,DEFAULT_VEHTYPE,36635976,578,591,13
car4.32,DEFAULT_VEHTYPE,14963731,512,591,79
car4.17,DEFAULT_VEHTYPE,cluster_1832615131_4075599903_5942692697_5942692700,592,594,2
car4.28,DEFAULT_VEHTYPE,cluster_1832615131_4075599903_5942692697_5942692700,592,594,2
car4.31,DEFAULT_VEHTYPE,14963731,509,594,85
car4.37,DEFAULT_VEHTYPE,cluster_1832615131_4075599903_5942692697_5942692700,588,594,6
car4.38,DEFAULT_VEHTYPE,cluster_1832615131_4075599903_5942692697_5942692700,591,594,3
car5.34,DEFAULT_VEHTYPE,122830043,551,594,43
car6.105,DEFAULT_VEHTYPE,122763218,554,594,40
car1.120,DEFAULT_VEHTYPE,36635979,559,595,36
car1.122,DEFAULT_VEHTYPE,36635979,565,595,30
car4.57,DEFAULT_VEHTYPE,14963731,595,596,1
car4.85,DEFAULT_VEHTYPE,20827734,593,596,3
car2.80,DEFAULT_VEHTYPE,122865866,531,597,66
car6.64,DEFAULT_VEHTYPE,123160850,592,597,5
car6.68,DEFAULT_VEHTYPE,123160850,595,597,2
car2.74,DEFAULT_VEHTYPE,122865866,529,598,69
car4.95,DEFAULT_VEHTYPE,122663827,591,598,7
car4.103,DEFAULT_VEHTYPE,123160863,568,599,31
car4.109,DEFAULT_VEHTYPE,123160863,569,599,30
car4.116,DEFAULT_VEHTYPE,3769264120,565,599,34
car3.133,DEFAULT_VEHTYPE,122763218,599,600,1
car4.106,DEFAULT_VEHTYPE,123160863,567,601,34
car4.118,DEFAULT_VEHTYPE,123160859,597,601,4
car4.120,DEFAULT_VEHTYPE,123160859,597,601,4
car4.121,DEFAULT_VEHTYPE,123160859,597,601,4
car4.122,DEFAULT_VEHTYPE,123160859,599,601,2
car4.123,DEFAULT_VEHTYPE,123160859,600,601,1
car4.125,DEFAULT_VEHTYPE,123160859,600,601,1
car4.57,DEFAULT_VEHTYPE,14963731,600,601,1
car3.71,DEFAULT_VEHTYPE,cluster_122688269_4075599865,597,602,5
car4.104,DEFAULT_VEHTYPE,123160863,567,602,35
car6.87,DEFAULT_VEHTYPE,GS_cluster_18314684_1833694981,574,602,28
car2.97,DEFAULT_VEHTYPE,11331520849,564,603,39
car3.45,DEFAULT_VEHTYPE,1686594171,578,603,25
car4.41,DEFAULT_VEHTYPE,14963731,601,603,2
car3.120,DEFAULT_VEHTYPE,122763218,559,604,45
car3.134,DEFAULT_VEHTYPE,122763218,603,604,1
car4.47,DEFAULT_VEHTYPE,14963731,587,604,17
car4.48,DEFAULT_VEHTYPE,14963731,593,604,11
car4.54,DEFAULT_VEHTYPE,14963731,591,604,13
car6.82,DEFAULT_VEHTYPE,GS_cluster_18314684_1833694981,573,604,31
car4.81,DEFAULT_VEHTYPE,20827734,603,605,2
car4.82,DEFAULT_VEHTYPE,20827734,601,605,4
car5.34,DEFAULT_VEHTYPE,1686594171,599,605,6
car3.63,DEFAULT_VEHTYPE,cluster_122688269_4075599865,564,606,42
car4.90,DEFAULT_VEHTYPE,20827734,605,606,1
car3.44,DEFAULT_VEHTYPE,cluster_122688249_4075599864,587,608,21
car3.93,DEFAULT_VEHTYPE,1686594183,604,608,4
car3.94,DEFAULT_VEHTYPE,1686594183,605,608,3
car4.114,DEFAULT_VEHTYPE,123160859,595,608,13
car4.117,DEFAULT_VEHTYPE,123160859,596,608,12
car4.119,DEFAULT_VEHTYPE,123160859,594,608,14
car6.84,DEFAULT_VEHTYPE,GS_cluster_18314684_1833694981,594,608,14
car6.88,DEFAULT_VEHTYPE,GS_cluster_18314684_1833694981,591,608,17
car6.89,DEFAULT_VEHTYPE,GS_cluster_18314684_1833694981,603,608,5
car3.135,DEFAULT_VEHTYPE,122763218,608,609,1
car6.83,DEFAULT_VEHTYPE,GS_cluster_18314684_1833694981,572,609,37
car1.92,DEFAULT_VEHTYPE,122865866,522,610,88
car4.89,DEFAULT_VEHTYPE,122663827,557,610,53
car5.17,DEFAULT_VEHTYPE,32581279,523,610,87
car5.18,DEFAULT_VEHTYPE,32581279,528,610,82
car5.19,DEFAULT_VEHTYPE,32581279,525,610,85
car5.22,DEFAULT_VEHTYPE,32581279,526,610,84
car1.91,DEFAULT_VEHTYPE,122865866,523,611,88
car3.131,DEFAULT_VEHTYPE,122763218,606,612,6
car3.132,DEFAULT_VEHTYPE,122763218,609,612,3
car4.104,DEFAULT_VEHTYPE,32581278,608,612,4
car4.111,DEFAULT_VEHTYPE,32581278,611,612,1
car4.112,DEFAULT_VEHTYPE,32581278,611,612,1
car4.115,DEFAULT_VEHTYPE,32581278,609,612,3
car6.127,DEFAULT_VEHTYPE,36635979,587,612,25
car6.128,DEFAULT_VEHTYPE,36635979,592,612,20
car6.129,DEFAULT_VEHTYPE,36635979,597,612,15
car6.130,DEFAULT_VEHTYPE,36635979,603,612,9
car6.131,DEFAULT_VEHTYPE,36635979,603,612,9
car6.132,DEFAULT_VEHTYPE,36635979,608,612,4
car4.55,DEFAULT_VEHTYPE,14963732,568,613,45
car5.28,DEFAULT_VEHTYPE,123527068,594,614,20
car5.30,DEFAULT_VEHTYPE,123527068,597,614,17
car5.31,DEFAULT_VEHTYPE,123527068,599,614,15
car5.32,DEFAULT_VEHTYPE,123527068,593,614,21
car6.117,DEFAULT_VEHTYPE,122763218,598,614,16
car3.72,DEFAULT_VEHTYPE,cluster_122688269_4075599865,611,615,4
car3.73,DEFAULT_VEHTYPE,cluster_122688269_4075599865,614,615,1
car4.101,DEFAULT_VEHTYPE,20827734,617,618,1
car6.66,DEFAULT_VEHTYPE,123160850,591,618,27
car3.121,DEFAULT_VEHTYPE,1686594173,612,621,9
car3.122,DEFAULT_VEHTYPE,1686594173,614,621,7
car3.123,DEFAULT_VEHTYPE,1686594173,616,621,5
car3.124,DEFAULT_VEHTYPE,1686594173,619,621,2
car4.11,DEFAULT_VEHTYPE,cluster_1687115220_4075599846,565,621,56
car5.16,DEFAULT_VEHTYPE,32581279,521,621,100
car4.71,DEFAULT_VEHTYPE,14963732,613,624,11
car4.72,DEFAULT_VEHTYPE,14963732,613,624,11
car3.47,DEFAULT_VEHTYPE,1686594171,620,625,5
car3.48,DEFAULT_VEHTYPE,1686594171,619,625,6
car3.49,DEFAULT_VEHTYPE,1686594171,621,625,4
car3.50,DEFAULT_VEHTYPE,1686594171,622,625,3
car3.51,DEFAULT_VEHTYPE,1686594171,620,625,5
car3.52,DEFAULT_VEHTYPE,1686594171,622,625,3
car3.53,DEFAULT_VEHTYPE,1686594171,624,625,1
car3.55,DEFAULT_VEHTYPE,1686594171,623,625,2
car4.21,DEFAULT_VEHTYPE,1686594183,622,625,3
car4.95,DEFAULT_VEHTYPE,122663827,602,625,23
car6.126,DEFAULT_VEHTYPE,36635979,583,625,42
car4.101,DEFAULT_VEHTYPE,20827734,622,626,4
car4.67,DEFAULT_VEHTYPE,20827734,572,626,54
car4.78,DEFAULT_VEHTYPE,20827734,592,626,34
car4.79,DEFAULT_VEHTYPE,20827734,573,626,53
car4.80,DEFAULT_VEHTYPE,20827734,577,626,49
car4.81,DEFAULT_VEHTYPE,20827734,609,626,17
car4.82,DEFAULT_VEHTYPE,20827734,609,626,17
car4.83,DEFAULT_VEHTYPE,20827734,586,626,40
car4.84,DEFAULT_VEHTYPE,20827734,599,626,27
car4.85,DEFAULT_VEHTYPE,20827734,599,626,27
car4.86,DEFAULT_VEHTYPE,20827734,623,626,3
car4.87,DEFAULT_VEHTYPE,20827734,576,626,50
car4.90,DEFAULT_VEHTYPE,20827734,615,626,11
car4.91,DEFAULT_VEHTYPE,20827734,614,626,12
car3.108,DEFAULT_VEHTYPE,122830043,585,627,42
car3.109,DEFAULT_VEHTYPE,122830043,587,627,40
car3.110,DEFAULT_VEHTYPE,122830043,610,627,17
car3.111,DEFAULT_VEHTYPE,122830043,611,627,16
car3.112,DEFAULT_VEHTYPE,122830043,614,627,13
car3.113,DEFAULT_VEHTYPE,122830043,615,627,12
car3.114,DEFAULT_VEHTYPE,122830043,618,627,9
car3.115,DEFAULT_VEHTYPE,122830043,619,627,8
car3.116,DEFAULT_VEHTYPE,122830043,621,627,6
car3.117,DEFAULT_VEHTYPE,122830043,622,627,5
car3.118,DEFAULT_VEHTYPE,122830043,623,627,4
car3.119,DEFAULT_VEHTYPE,122830043,624,627,3
car3.92,DEFAULT_VEHTYPE,1686594183,602,627,25
car4.118,DEFAULT_VEHTYPE,3769264120,618,627,9
car4.120,DEFAULT_VEHTYPE,3769264120,617,627,10
car4.121,DEFAULT_VEHTYPE,3769264120,617,627,10
car4.122,DEFAULT_VEHTYPE,3769264120,620,627,7
car4.123,DEFAULT_VEHTYPE,3769264120,618,627,9
car4.124,DEFAULT_VEHTYPE,3769264120,621,627,6
car4.125,DEFAULT_VEHTYPE,3769264120,619,627,8
car4.126,DEFAULT_VEHTYPE,3769264120,621,627,6
car4.127,DEFAULT_VEHTYPE,3769264120,623,627,4
car4.128,DEFAULT_VEHTYPE,3769264120,621,627,6
car6.125,DEFAULT_VEHTYPE,36635979,580,627,47
car1.123,DEFAULT_VEHTYPE,36635976,625,628,3
car1.125,DEFAULT_VEHTYPE,36635976,626,628,2
car2.116,DEFAULT_VEHTYPE,cluster_1832615131_4075599903_5942692697_5942692700,594,628,34
car2.118,DEFAULT_VEHTYPE,cluster_1832615131_4075599903_5942692697_5942692700,599,628,29
car2.119,DEFAULT_VEHTYPE,cluster_1832615131_4075599903_5942692697_5942692700,597,628,31
car2.120,DEFAULT_VEHTYPE,cluster_1832615131_4075599903_5942692697_5942692700,599,628,29
car2.122,DEFAULT_VEHTYPE,cluster_1832615131_4075599903_5942692697_5942692700,617,628,11
car2.124,DEFAULT_VEHTYPE,cluster_1832615131_4075599903_5942692697_5942692700,610,628,18
car2.76,DEFAULT_VEHTYPE,36635976,618,628,10
car4.36,DEFAULT_VEHTYPE,cluster_1687115220_4075599846,534,628,94
car4.98,DEFAULT_VEHTYPE,122663827,588,628,40
car4.45,DEFAULT_VEHTYPE,cluster_1687115220_4075599846,607,629,22
car4.55,DEFAULT_VEHTYPE,14963731,626,629,3
car4.69,DEFAULT_VEHTYPE,14963731,627,629,2
car4.49,DEFAULT_VEHTYPE,cluster_1687115220_4075599846,609,630,21
car3.140,DEFAULT_VEHTYPE,122763218,630,631,1
car4.39,DEFAULT_VEHTYPE,cluster_1687115220_4075599846,614,631,17
car4.42,DEFAULT_VEHTYPE,cluster_1687115220_4075599846,610,631,21
car4.60,DEFAULT_VEHTYPE,cluster_1687115220_4075599846,613,631,18
car6.81,DEFAULT_VEHTYPE,16218739,630,631,1
car6.82,DEFAULT_VEHTYPE,16218739,626,631,5
car6.85,DEFAULT_VEHTYPE,16218739,628,631,3
car6.87,DEFAULT_VEHTYPE,16218739,624,631,7
car4.103,DEFAULT_VEHTYPE,32581278,605,632,27
car4.109,DEFAULT_VEHTYPE,32581278,605,633,28
car2.133,DEFAULT_VEHTYPE,36635968,630,634,4
car2.134,DEFAULT_VEHTYPE,36635968,631,634,3
car4.106,DEFAULT_VEHTYPE,32581278,606,634,28
car4.129,DEFAULT_VEHTYPE,123160850,598,635,37
car4.130,DEFAULT_VEHTYPE,123160850,601,635,34
car4.131,DEFAULT_VEHTYPE,123160850,606,635,29
car4.132,DEFAULT_VEHTYPE,123160850,610,635,25
car4.133,DEFAULT_VEHTYPE,123160850,615,635,20
car4.134,DEFAULT_VEHTYPE,123160850,618,635,17
car4.135,DEFAULT_VEHTYPE,123160850,624,635,11
car4.136,DEFAULT_VEHTYPE,123160850,627,635,8
car4.137,DEFAULT_VEHTYPE,123160850,632,635,3
car4.69,DEFAULT_VEHTYPE,14963731,634,635,1
car3.141,DEFAULT_VEHTYPE,122763218,635,636,1
car4.114,DEFAULT_VEHTYPE,3769264120,614,636,22
car4.117,DEFAULT_VEHTYPE,3769264120,617,636,19
car4.119,DEFAULT_VEHTYPE,3769264120,615,636,21
car4.58,DEFAULT_VEHTYPE,14963731,635,636,1
car6.102,DEFAULT_VEHTYPE,122763207,634,636,2
car1.120,DEFAULT_VEHTYPE,36635976,624,639,15
car1.122,DEFAULT_VEHTYPE,36635976,623,639,16
car4.69,DEFAULT_VEHTYPE,14963731,636,639,3
car1.133,DEFAULT_VEHTYPE,36635979,613,640,27
car1.134,DEFAULT_VEHTYPE,36635979,618,640,22
car1.135,DEFAULT_VEHTYPE,36635979,621,640,19
car1.136,DEFAULT_VEHTYPE,36635979,627,640,13
car1.137,DEFAULT_VEHTYPE,36635979,629,640,11
car3.138,DEFAULT_VEHTYPE,122763218,638,640,2
car3.142,DEFAULT_VEHTYPE,122763218,639,640,1
car4.39,DEFAULT_VEHTYPE,cluster_1687115220_4075599846,639,640,1
car4.42,DEFAULT_VEHTYPE,cluster_1687115220_4075599846,638,640,2
car4.49,DEFAULT_VEHTYPE,cluster_1687115220_4075599846,636,640,4
car4.58,DEFAULT_VEHTYPE,14963731,637,640,3
car4.60,DEFAULT_VEHTYPE,cluster_1687115220_4075599846,638,640,2
car3.120,DEFAULT_VEHTYPE,1686594173,609,641,32
car4.66,DEFAULT_VEHTYPE,14963731,639,641,2
car5.35,DEFAULT_VEHTYPE,122574871,625,643,18
car4.116,DEFAULT_VEHTYPE,123160863,604,644,40
car4.65,DEFAULT_VEHTYPE,20827734,565,644,79
car6.118,DEFAULT_VEHTYPE,GS_cluster_10738391828_178489893,621,644,23
car6.119,DEFAULT_VEHTYPE,GS_cluster_10738391828_178489893,623,644,21
car6.120,DEFAULT_VEHTYPE,GS_cluster_10738391828_178489893,623,644,21
car6.121,DEFAULT_VEHTYPE,GS_cluster_10738391828_178489893,625,644,19
car6.122,DEFAULT_VEHTYPE,GS_cluster_10738391828_178489893,627,644,17
car6.88,DEFAULT_VEHTYPE,122763207,633,644,11
car2.83,DEFAULT_VEHTYPE,36635976,623,645,22
car3.130,DEFAULT_VEHTYPE,122763218,604,645,41
car3.44,DEFAULT_VEHTYPE,1686594171,615,645,30
car2.80,DEFAULT_VEHTYPE,36635976,615,646,31
car3.107,DEFAULT_VEHTYPE,122830043,583,646,63
car3.46,DEFAULT_VEHTYPE,1686594171,614,646,32
car2.81,DEFAULT_VEHTYPE,36635976,616,648,32
car1.131,DEFAULT_VEHTYPE,36635979,604,649,45
car1.132,DEFAULT_VEHTYPE,36635979,608,649,41
car3.144,DEFAULT_VEHTYPE,122763218,648,649,1
car5.44,DEFAULT_VEHTYPE,122865866,561,649,88
car3.65,DEFAULT_VEHTYPE,cluster_14963716_27976732_3892769467,611,650,39
car3.66,DEFAULT_VEHTYPE,cluster_14963716_27976732_3892769467,612,650,38
car4.102,DEFAULT_VEHTYPE,cluster_123160878_2450046772,614,651,37
car4.89,DEFAULT_VEHTYPE,cluster_123160878_2450046772,617,651,34
car4.92,DEFAULT_VEHTYPE,cluster_123160878_2450046772,616,651,35
car4.95,DEFAULT_VEHTYPE,cluster_123160878_2450046772,629,651,22
car4.97,DEFAULT_VEHTYPE,cluster_123160878_2450046772,611,651,40
car4.98,DEFAULT_VEHTYPE,cluster_123160878_2450046772,630,651,21
car4.68,DEFAULT_VEHTYPE,14963731,651,652,1
car6.124,DEFAULT_VEHTYPE,122763218,621,652,31
car2.115,DEFAULT_VEHTYPE,cluster_1832615131_4075599903_5942692697_5942692700,591,653,62
car3.145,DEFAULT_VEHTYPE,122763218,653,654,1
car2.117,DEFAULT_VEHTYPE,cluster_1832615131_4075599903_5942692697_5942692700,596,655,59
car3.101,DEFAULT_VEHTYPE,1686594183,632,655,23
car3.102,DEFAULT_VEHTYPE,1686594183,633,655,22
car6.117,DEFAULT_VEHTYPE,GS_cluster_10738391828_178489893,619,655,36
car6.81,DEFAULT_VEHTYPE,123160850,651,655,4
car6.85,DEFAULT_VEHTYPE,123160850,651,655,4
car1.87,DEFAULT_VEHTYPE,11331520849,541,658,117
car3.146,DEFAULT_VEHTYPE,122763218,657,658,1
car3.71,DEFAULT_VEHTYPE,cluster_122688269_4075599865,606,659,53
car6.102,DEFAULT_VEHTYPE,122763204,651,659,8
car6.116,DEFAULT_VEHTYPE,GS_cluster_10738391828_178489893,621,659,38
car6.137,DEFAULT_VEHTYPE,36635979,634,659,25
car6.138,DEFAULT_VEHTYPE,36635979,637,659,22
car6.139,DEFAULT_VEHTYPE,36635979,642,659,17
car6.140,DEFAULT_VEHTYPE,36635979,645,659,14
car6.141,DEFAULT_VEHTYPE,36635979,651,659,8
car6.142,DEFAULT_VEHTYPE,36635979,655,659,4
car6.88,DEFAULT_VEHTYPE,122763204,651,659,8
car4.68,DEFAULT_VEHTYPE,14963731,657,660,3
car2.131,DEFAULT_VEHTYPE,36635968,621,661,40
car3.131,DEFAULT_VEHTYPE,1686594173,654,661,7
car3.132,DEFAULT_VEHTYPE,1686594173,656,661,5
car3.133,DEFAULT_VEHTYPE,1686594173,657,661,4
car3.134,DEFAULT_VEHTYPE,1686594173,659,661,2
car4.131,DEFAULT_VEHTYPE,123160859,654,661,7
car4.133,DEFAULT_VEHTYPE,123160859,654,661,7
car4.134,DEFAULT_VEHTYPE,123160859,653,661,8
car4.135,DEFAULT_VEHTYPE,123160859,655,661,6
car4.136,DEFAULT_VEHTYPE,123160859,656,661,5
car4.137,DEFAULT_VEHTYPE,123160859,657,661,4
car4.138,DEFAULT_VEHTYPE,123160859,656,661,5
car4.139,DEFAULT_VEHTYPE,123160859,658,661,3
car4.140,DEFAULT_VEHTYPE,123160859,657,661,4
car4.141,DEFAULT_VEHTYPE,123160859,660,661,1
car4.93,DEFAULT_VEHTYPE,cluster_123160878_2450046772,608,661,53
car6.126,DEFAULT_VEHTYPE,122763218,647,661,14
car2.105,DEFAULT_VEHTYPE,122596361,641,662,21
car2.132,DEFAULT_VEHTYPE,36635968,626,662,36
car6.141,DEFAULT_VEHTYPE,36635979,661,662,1
car6.142,DEFAULT_VEHTYPE,36635979,661,662,1
car3.147,DEFAULT_VEHTYPE,122763218,662,663,1
car3.70,DEFAULT_VEHTYPE,cluster_122688269_4075599865,595,663,68
car4.59,DEFAULT_VEHTYPE,14963731,656,663,7
car5.33,DEFAULT_VEHTYPE,123527068,629,663,34
car6.143,DEFAULT_VEHTYPE,36635979,661,663,2
car6.144,DEFAULT_VEHTYPE,36635979,662,663,1
car2.108,DEFAULT_VEHTYPE,122596361,646,665,19
car4.76,DEFAULT_VEHTYPE,20827734,591,666,75
car3.148,DEFAULT_VEHTYPE,122763218,666,667,1
car4.11,DEFAULT_VEHTYPE,cluster_1832615131_4075599903_5942692697_5942692700,658,667,9
car4.21,DEFAULT_VEHTYPE,cluster_1832615131_4075599903_5942692697_5942692700,656,667,11
car4.25,DEFAULT_VEHTYPE,cluster_1832615131_4075599903_5942692697_5942692700,661,667,6
car4.27,DEFAULT_VEHTYPE,cluster_1832615131_4075599903_5942692697_5942692700,664,667,3
car4.30,DEFAULT_VEHTYPE,cluster_1832615131_4075599903_5942692697_5942692700,665,667,2
car4.33,DEFAULT_VEHTYPE,cluster_1832615131_4075599903_5942692697_5942692700,665,667,2
car4.36,DEFAULT_VEHTYPE,cluster_1832615131_4075599903_5942692697_5942692700,663,667,4
car4.43,DEFAULT_VEHTYPE,cluster_1832615131_4075599903_5942692697_5942692700,661,667,6
car4.59,DEFAULT_VEHTYPE,14963731,666,667,1
car5.34,DEFAULT_VEHTYPE,122574871,623,667,44
car4.118,DEFAULT_VEHTYPE,123160863,644,668,24
car4.120,DEFAULT_VEHTYPE,123160863,644,668,24
car4.122,DEFAULT_VEHTYPE,123160863,645,668,23
car4.123,DEFAULT_VEHTYPE,123160863,647,668,21
car4.124,DEFAULT_VEHTYPE,123160863,647,668,21
car4.125,DEFAULT_VEHTYPE,123160863,646,668,22
car4.126,DEFAULT_VEHTYPE,123160863,647,668,21
car4.128,DEFAULT_VEHTYPE,123160863,647,668,21
car4.129,DEFAULT_VEHTYPE,123160859,651,668,17
car4.130,DEFAULT_VEHTYPE,123160859,652,668,16
car3.140,DEFAULT_VEHTYPE,122763218,650,669,19
car3.141,DEFAULT_VEHTYPE,122763218,652,669,17
car3.142,DEFAULT_VEHTYPE,122763218,654,669,15
car3.143,DEFAULT_VEHTYPE,122763218,659,669,10
car3.144,DEFAULT_VEHTYPE,122763218,662,669,7
car3.145,DEFAULT_VEHTYPE,122763218,667,669,2
car3.64,DEFAULT_VEHTYPE,cluster_14963716_27976732_3892769467,603,669,66
car4.132,DEFAULT_VEHTYPE,123160859,651,669,18
car3.63,DEFAULT_VEHTYPE,cluster_14963716_27976732_3892769467,609,670,61
car2.73,DEFAULT_VEHTYPE,36635979,668,672,4
car2.75,DEFAULT_VEHTYPE,36635979,670,672,2
car2.76,DEFAULT_VEHTYPE,36635979,668,672,4
car2.85,DEFAULT_VEHTYPE,36635979,667,672,5
car2.90,DEFAULT_VEHTYPE,36635979,663,672,9
car3.137,DEFAULT_VEHTYPE,122763218,633,672,39
car3.100,DEFAULT_VEHTYPE,1686594183,626,673,47
car5.43,DEFAULT_VEHTYPE,122865866,560,673,113
car4.127,DEFAULT_VEHTYPE,3769264120,640,674,34
car1.93,DEFAULT_VEHTYPE,11331520849,617,675,58
car1.94,DEFAULT_VEHTYPE,11331520849,621,675,54
car1.95,DEFAULT_VEHTYPE,11331520849,617,675,58
car1.96,DEFAULT_VEHTYPE,11331520849,620,675,55
car2.116,DEFAULT_VEHTYPE,11331520849,665,675,10
car2.117,DEFAULT_VEHTYPE,11331520849,662,675,13
car2.118,DEFAULT_VEHTYPE,11331520849,673,675,2
car2.120,DEFAULT_VEHTYPE,11331520849,670,675,5
car2.122,DEFAULT_VEHTYPE,11331520849,669,675,6
car2.124,DEFAULT_VEHTYPE,11331520849,666,675,9
car2.141,DEFAULT_VEHTYPE,36635968,668,675,7
car2.142,DEFAULT_VEHTYPE,36635968,670,675,5
car3.46,DEFAULT_VEHTYPE,GS_cluster_10738391828_178489893,668,675,7
car4.52,DEFAULT_VEHTYPE,14963731,624,676,52
car4.58,DEFAULT_VEHTYPE,14963731,645,676,31
car4.59,DEFAULT_VEHTYPE,14963731,668,676,8
car4.62,DEFAULT_VEHTYPE,14963731,668,676,8
car4.66,DEFAULT_VEHTYPE,14963731,647,676,29
car4.68,DEFAULT_VEHTYPE,14963731,663,676,13
car4.73,DEFAULT_VEHTYPE,14963731,649,676,27
car4.93,DEFAULT_VEHTYPE,20827734,666,676,10
car4.76,DEFAULT_VEHTYPE,14963732,669,677,8
car4.86,DEFAULT_VEHTYPE,14963732,667,677,10
car4.97,DEFAULT_VEHTYPE,20827734,667,677,10
car4.102,DEFAULT_VEHTYPE,20827734,669,678,9
car6.82,DEFAULT_VEHTYPE,123160850,650,678,28
car4.92,DEFAULT_VEHTYPE,20827734,672,679,7
car4.89,DEFAULT_VEHTYPE,20827734,675,680,5
car6.87,DEFAULT_VEHTYPE,123160850,649,680,31
car6.102,DEFAULT_VEHTYPE,16218739,664,681,17
car6.103,DEFAULT_VEHTYPE,16218739,666,681,15
car6.84,DEFAULT_VEHTYPE,16218739,667,681,14
car6.88,DEFAULT_VEHTYPE,16218739,664,681,17
car6.90,DEFAULT_VEHTYPE,16218739,668,681,13
car6.91,DEFAULT_VEHTYPE,16218739,668,681,13
car1.145,DEFAULT_VEHTYPE,36635979,668,682,14
car3.130,DEFAULT_VEHTYPE,1686594173,651,682,31
car6.116,DEFAULT_VEHTYPE,GS_cluster_18314684_1833694981,678,685,7
car6.120,DEFAULT_VEHTYPE,GS_cluster_18314684_1833694981,680,685,5
car6.124,DEFAULT_VEHTYPE,GS_cluster_18314684_1833694981,681,686,5
car1.123,DEFAULT_VEHTYPE,122865866,667,687,20
car1.124,DEFAULT_VEHTYPE,122865866,670,687,17
car1.125,DEFAULT_VEHTYPE,122865866,670,687,17
car1.126,DEFAULT_VEHTYPE,122865866,672,687,15
car1.127,DEFAULT_VEHTYPE,122865866,672,687,15
car1.128,DEFAULT_VEHTYPE,122865866,673,687,14
car1.129,DEFAULT_VEHTYPE,122865866,673,687,14
car1.130,DEFAULT_VEHTYPE,122865866,674,687,13
car3.108,DEFAULT_VEHTYPE,1686594183,679,688,9
car3.109,DEFAULT_VEHTYPE,1686594183,681,688,7
car4.114,DEFAULT_VEHTYPE,123160863,642,688,46
car4.119,DEFAULT_VEHTYPE,123160863,642,688,46
car4.59,DEFAULT_VEHTYPE,14963731,681,688,7
car4.68,DEFAULT_VEHTYPE,14963731,682,688,6
car5.21,DEFAULT_VEHTYPE,32581279,633,688,55
car5.23,DEFAULT_VEHTYPE,32581279,634,688,54
car5.26,DEFAULT_VEHTYPE,32581279,638,688,50
car5.27,DEFAULT_VEHTYPE,32581279,636,688,52
car6.118,DEFAULT_VEHTYPE,GS_cluster_18314684_1833694981,676,688,12
car6.87,DEFAULT_VEHTYPE,1927992928,684,688,4
car1.142,DEFAULT_VEHTYPE,36635976,687,689,2
car4.121,DEFAULT_VEHTYPE,123160863,643,689,46
car4.117,DEFAULT_VEHTYPE,123160863,641,691,50
car4.75,DEFAULT_VEHTYPE,20827734,581,691,110
car6.120,DEFAULT_VEHTYPE,GS_cluster_18314684_1833694981,690,691,1
car6.86,DEFAULT_VEHTYPE,16218739,639,691,52
car4.59,DEFAULT_VEHTYPE,14963731,691,692,1
car6.83,DEFAULT_VEHTYPE,16218739,641,692,51
car2.114,DEFAULT_VEHTYPE,852777135,692,693,1
car4.144,DEFAULT_VEHTYPE,123160850,664,693,29
car4.146,DEFAULT_VEHTYPE,123160850,672,693,21
car4.147,DEFAULT_VEHTYPE,123160850,677,693,16
car4.148,DEFAULT_VEHTYPE,123160850,682,693,11
car4.149,DEFAULT_VEHTYPE,123160850,686,693,7
car4.150,DEFAULT_VEHTYPE,123160850,690,693,3
car4.55,DEFAULT_VEHTYPE,14963731,633,693,60
car5.43,DEFAULT_VEHTYPE,122830043,674,693,19
car6.120,DEFAULT_VEHTYPE,GS_cluster_18314684_1833694981,692,693,1
car4.111,DEFAULT_VEHTYPE,20827734,690,694,4
car4.115,DEFAULT_VEHTYPE,20827734,687,694,7
car4.59,DEFAULT_VEHTYPE,14963731,693,694,1
car4.64,DEFAULT_VEHTYPE,14963731,688,694,6
car4.69,DEFAULT_VEHTYPE,14963731,643,695,52
car5.29,DEFAULT_VEHTYPE,123527068,590,695,105
car6.120,DEFAULT_VEHTYPE,GS_cluster_18314684_1833694981,694,695,1
car4.108,DEFAULT_VEHTYPE,20827734,695,696,1
car4.114,DEFAULT_VEHTYPE,32581278,695,696,1
car4.119,DEFAULT_VEHTYPE,32581278,695,696,1
car6.124,DEFAULT_VEHTYPE,GS_cluster_18314684_1833694981,695,696,1
car3.139,DEFAULT_VEHTYPE,122763218,648,697,49
car4.105,DEFAULT_VEHTYPE,20827734,696,697,1
car6.119,DEFAULT_VEHTYPE,GS_cluster_18314684_1833694981,696,697,1
car4.141,DEFAULT_VEHTYPE,123160859,674,698,24
car3.155,DEFAULT_VEHTYPE,122763218,698,699,1
car4.111,DEFAULT_VEHTYPE,20827734,698,699,1
car4.51,DEFAULT_VEHTYPE,14963731,698,699,1
car5.25,DEFAULT_VEHTYPE,32581279,629,699,70
car6.119,DEFAULT_VEHTYPE,GS_cluster_18314684_1833694981,699,700,1
car6.124,DEFAULT_VEHTYPE,GS_cluster_18314684_1833694981,697,700,3
car2.119,DEFAULT_VEHTYPE,11331520849,664,701,37
car4.111,DEFAULT_VEHTYPE,20827734,700,701,1
car4.75,DEFAULT_VEHTYPE,14963732,696,701,5
car4.76,DEFAULT_VEHTYPE,14963732,694,701,7
car4.108,DEFAULT_VEHTYPE,20827734,701,702,1
car2.115,DEFAULT_VEHTYPE,11331520849,661,703,42
car3.156,DEFAULT_VEHTYPE,122763218,702,703,1
car4.142,DEFAULT_VEHTYPE,123160850,656,703,47
car4.143,DEFAULT_VEHTYPE,123160850,660,703,43
car4.145,DEFAULT_VEHTYPE,123160850,670,703,33
car4.64,DEFAULT_VEHTYPE,14963731,697,703,6
car6.121,DEFAULT_VEHTYPE,GS_cluster_18314684_1833694981,700,703,3
car6.125,DEFAULT_VEHTYPE,GS_cluster_10738391828_178489893,669,704,35
car6.127,DEFAULT_VEHTYPE,GS_cluster_10738391828_178489893,670,704,34
car6.129,DEFAULT_VEHTYPE,GS_cluster_10738391828_178489893,671,704,33
car6.131,DEFAULT_VEHTYPE,GS_cluster_10738391828_178489893,671,704,33
car6.132,DEFAULT_VEHTYPE,GS_cluster_10738391828_178489893,673,704,31
car2.133,DEFAULT_VEHTYPE,cluster_1832615131_4075599903_5942692697_5942692700,670,705,35
car2.134,DEFAULT_VEHTYPE,cluster_1832615131_4075599903_5942692697_5942692700,669,705,36
car2.135,DEFAULT_VEHTYPE,cluster_1832615131_4075599903_5942692697_5942692700,673,705,32
car2.136,DEFAULT_VEHTYPE,cluster_1832615131_4075599903_5942692697_5942692700,670,705,35
car2.137,DEFAULT_VEHTYPE,cluster_1832615131_4075599903_5942692697_5942692700,674,705,31
car2.138,DEFAULT_VEHTYPE,cluster_1832615131_4075599903_5942692697_5942692700,676,705,29
car5.31,DEFAULT_VEHTYPE,123527068,627,705,78
car6.100,DEFAULT_VEHTYPE,122763207,692,705,13
car6.105,DEFAULT_VEHTYPE,122763207,695,705,10
car6.106,DEFAULT_VEHTYPE,122763207,690,705,15
car6.113,DEFAULT_VEHTYPE,122763207,696,705,9
car6.119,DEFAULT_VEHTYPE,GS_cluster_18314684_1833694981,702,705,3
car4.51,DEFAULT_VEHTYPE,14963731,700,706,6
car6.120,DEFAULT_VEHTYPE,GS_cluster_18314684_1833694981,696,706,10
car6.122,DEFAULT_VEHTYPE,GS_cluster_18314684_1833694981,705,706,1
car6.123,DEFAULT_VEHTYPE,GS_cluster_18314684_1833694981,702,706,4
car6.124,DEFAULT_VEHTYPE,GS_cluster_18314684_1833694981,704,706,2
car3.107,DEFAULT_VEHTYPE,1686594183,677,707,30
car3.153,DEFAULT_VEHTYPE,122763218,707,708,1
car3.157,DEFAULT_VEHTYPE,122763218,707,708,1
car6.102,DEFAULT_VEHTYPE,123160850,699,709,10
car6.103,DEFAULT_VEHTYPE,123160850,700,709,9
car6.108,DEFAULT_VEHTYPE,123160850,705,709,4
car6.84,DEFAULT_VEHTYPE,123160850,700,709,9
car6.88,DEFAULT_VEHTYPE,123160850,699,709,10
car6.89,DEFAULT_VEHTYPE,123160850,706,709,3
car6.90,DEFAULT_VEHTYPE,123160850,703,709,6
car6.91,DEFAULT_VEHTYPE,123160850,704,709,5
car6.96,DEFAULT_VEHTYPE,123160850,707,709,2
car6.98,DEFAULT_VEHTYPE,123160850,705,709,4
car2.140,DEFAULT_VEHTYPE,36635968,660,711,51
car4.41,DEFAULT_VEHTYPE,cluster_1687115220_4075599846,683,711,28
car4.52,DEFAULT_VEHTYPE,cluster_1687115220_4075599846,699,711,12
car4.54,DEFAULT_VEHTYPE,cluster_1687115220_4075599846,680,711,31
car4.55,DEFAULT_VEHTYPE,cluster_1687115220_4075599846,697,711,14
car4.69,DEFAULT_VEHTYPE,cluster_1687115220_4075599846,698,711,13
car4.74,DEFAULT_VEHTYPE,cluster_1687115220_4075599846,681,711,30
car3.63,DEFAULT_VEHTYPE,1686594171,695,713,18
car3.65,DEFAULT_VEHTYPE,1686594171,697,713,16
car3.68,DEFAULT_VEHTYPE,1686594171,697,713,16
car3.69,DEFAULT_VEHTYPE,1686594171,695,713,18
car3.70,DEFAULT_VEHTYPE,1686594171,708,713,5
car3.71,DEFAULT_VEHTYPE,1686594171,700,713,13
car3.72,DEFAULT_VEHTYPE,1686594171,706,713,7
car3.73,DEFAULT_VEHTYPE,1686594171,703,713,10
car3.74,DEFAULT_VEHTYPE,1686594171,705,713,8
car3.75,DEFAULT_VEHTYPE,1686594171,707,713,6
car3.77,DEFAULT_VEHTYPE,1686594171,708,713,5
car2.139,DEFAULT_VEHTYPE,36635968,662,714,52
car4.102,DEFAULT_VEHTYPE,20827734,683,714,31
car4.105,DEFAULT_VEHTYPE,20827734,706,714,8
car4.107,DEFAULT_VEHTYPE,20827734,708,714,6
car4.108,DEFAULT_VEHTYPE,20827734,703,714,11
car4.109,DEFAULT_VEHTYPE,20827734,682,714,32
car4.110,DEFAULT_VEHTYPE,20827734,711,714,3
car4.111,DEFAULT_VEHTYPE,20827734,702,714,12
car4.113,DEFAULT_VEHTYPE,20827734,713,714,1
car4.115,DEFAULT_VEHTYPE,20827734,697,714,17
car4.51,DEFAULT_VEHTYPE,14963731,709,714,5
car4.56,DEFAULT_VEHTYPE,14963731,711,714,3
car4.58,DEFAULT_VEHTYPE,14963731,683,714,31
car4.59,DEFAULT_VEHTYPE,14963731,695,714,19
car4.62,DEFAULT_VEHTYPE,14963731,687,714,27
car4.64,DEFAULT_VEHTYPE,14963731,707,714,7
car4.66,DEFAULT_VEHTYPE,14963731,682,714,32
car4.68,DEFAULT_VEHTYPE,14963731,691,714,23
car4.73,DEFAULT_VEHTYPE,14963731,685,714,29
car4.89,DEFAULT_VEHTYPE,20827734,687,714,27
car4.92,DEFAULT_VEHTYPE,20827734,685,714,29
car4.95,DEFAULT_VEHTYPE,20827734,688,714,26
car4.97,DEFAULT_VEHTYPE,20827734,682,714,32
car6.109,DEFAULT_VEHTYPE,122763207,689,714,25
car4.141,DEFAULT_VEHTYPE,3769264120,705,715,10
car6.126,DEFAULT_VEHTYPE,GS_cluster_10738391828_178489893,667,715,48
car6.128,DEFAULT_VEHTYPE,GS_cluster_10738391828_178489893,665,715,50
car6.94,DEFAULT_VEHTYPE,122763204,698,715,17
car1.122,DEFAULT_VEHTYPE,122865866,667,716,49
car5.50,DEFAULT_VEHTYPE,122865866,668,716,48
car6.119,DEFAULT_VEHTYPE,GS_cluster_18314684_1833694981,715,716,1
car6.138,DEFAULT_VEHTYPE,122763218,698,716,18
car1.120,DEFAULT_VEHTYPE,122865866,665,717,52
car4.56,DEFAULT_VEHTYPE,14963731,717,718,1
car4.73,DEFAULT_VEHTYPE,14963731,717,718,1
car5.39,DEFAULT_VEHTYPE,123527068,682,718,36
car5.40,DEFAULT_VEHTYPE,123527068,684,718,34
car5.41,DEFAULT_VEHTYPE,123527068,685,718,33
car4.45,DEFAULT_VEHTYPE,cluster_1687115220_4075599846,634,719,85
car5.21,DEFAULT_VEHTYPE,32581278,705,719,14
car5.23,DEFAULT_VEHTYPE,32581278,710,719,9
car5.26,DEFAULT_VEHTYPE,32581278,713,719,6
car5.27,DEFAULT_VEHTYPE,32581278,711,719,8
car6.141,DEFAULT_VEHTYPE,36635979,667,719,52
car6.142,DEFAULT_VEHTYPE,36635979,667,719,52
car6.143,DEFAULT_VEHTYPE,36635979,668,719,51
car6.144,DEFAULT_VEHTYPE,36635979,669,719,50
car6.145,DEFAULT_VEHTYPE,36635979,671,719,48
car6.146,DEFAULT_VEHTYPE,36635979,674,719,45
car2.152,DEFAULT_VEHTYPE,36635968,712,720,8
car4.144,DEFAULT_VEHTYPE,123160859,711,721,10
car4.146,DEFAULT_VEHTYPE,123160859,711,721,10
car4.147,DEFAULT_VEHTYPE,123160859,713,721,8
car4.148,DEFAULT_VEHTYPE,123160859,711,721,10
car4.149,DEFAULT_VEHTYPE,123160859,713,721,8
car4.150,DEFAULT_VEHTYPE,123160859,715,721,6
car4.151,DEFAULT_VEHTYPE,123160859,712,721,9
car4.152,DEFAULT_VEHTYPE,123160859,715,721,6
car4.153,DEFAULT_VEHTYPE,123160859,716,721,5
car4.31,DEFAULT_VEHTYPE,cluster_1687115220_4075599846,606,721,115
car4.75,DEFAULT_VEHTYPE,14963732,715,721,6
car4.79,DEFAULT_VEHTYPE,14963732,715,721,6
car5.43,DEFAULT_VEHTYPE,122686666,704,721,17
car3.131,DEFAULT_VEHTYPE,122830043,696,722,26
car3.132,DEFAULT_VEHTYPE,122830043,697,722,25
car3.133,DEFAULT_VEHTYPE,122830043,698,722,24
car3.134,DEFAULT_VEHTYPE,122830043,701,722,21
car3.135,DEFAULT_VEHTYPE,122830043,702,722,20
car3.136,DEFAULT_VEHTYPE,122830043,704,722,18
car3.137,DEFAULT_VEHTYPE,122830043,706,722,16
car3.138,DEFAULT_VEHTYPE,122830043,707,722,15
car4.41,DEFAULT_VEHTYPE,cluster_1687115220_4075599846,716,722,6
car4.51,DEFAULT_VEHTYPE,14963731,720,722,2
car4.55,DEFAULT_VEHTYPE,cluster_1687115220_4075599846,716,722,6
car1.151,DEFAULT_VEHTYPE,852777135,702,723,21
car1.152,DEFAULT_VEHTYPE,852777135,710,723,13
car1.153,DEFAULT_VEHTYPE,852777135,712,723,11
car1.154,DEFAULT_VEHTYPE,852777135,719,723,4
car2.103,DEFAULT_VEHTYPE,852777135,698,723,25
car2.107,DEFAULT_VEHTYPE,852777135,699,723,24
car2.108,DEFAULT_VEHTYPE,852777135,696,723,27
car2.113,DEFAULT_VEHTYPE,852777135,701,723,22
car2.114,DEFAULT_VEHTYPE,852777135,699,723,24
car4.69,DEFAULT_VEHTYPE,cluster_1687115220_4075599846,716,723,7
car6.117,DEFAULT_VEHTYPE,GS_cluster_18314684_1833694981,674,723,49
car4.52,DEFAULT_VEHTYPE,cluster_1687115220_4075599846,716,724,8
car4.53,DEFAULT_VEHTYPE,14963732,613,724,111
car4.114,DEFAULT_VEHTYPE,122663827,723,725,2
car4.119,DEFAULT_VEHTYPE,122663827,722,725,3
car4.121,DEFAULT_VEHTYPE,122663827,724,725,1
car6.118,DEFAULT_VEHTYPE,GS_cluster_18314684_1833694981,691,725,34
car4.75,DEFAULT_VEHTYPE,14963732,725,726,1
car1.141,DEFAULT_VEHTYPE,36635976,708,728,20
car1.143,DEFAULT_VEHTYPE,36635976,698,728,30
car1.145,DEFAULT_VEHTYPE,36635976,708,728,20
car1.146,DEFAULT_VEHTYPE,36635976,708,728,20
car1.147,DEFAULT_VEHTYPE,36635976,704,728,24
car1.149,DEFAULT_VEHTYPE,36635976,712,728,16
car4.142,DEFAULT_VEHTYPE,123160859,708,728,20
car4.143,DEFAULT_VEHTYPE,123160859,710,728,18
car4.145,DEFAULT_VEHTYPE,123160859,709,728,19
car1.92,DEFAULT_VEHTYPE,11331520849,615,729,114
car4.53,DEFAULT_VEHTYPE,14963731,727,729,2
car5.38,DEFAULT_VEHTYPE,123527068,682,729,47
car1.91,DEFAULT_VEHTYPE,11331520849,615,730,115
car6.83,DEFAULT_VEHTYPE,123160850,698,730,32
car4.55,DEFAULT_VEHTYPE,cluster_1687115220_4075599846,728,731,3
car6.106,DEFAULT_VEHTYPE,122763204,721,731,10
car6.109,DEFAULT_VEHTYPE,122763204,719,731,12
car2.132,DEFAULT_VEHTYPE,cluster_1832615131_4075599903_5942692697_5942692700,667,732,65
car3.64,DEFAULT_VEHTYPE,1686594171,692,732,40
car4.69,DEFAULT_VEHTYPE,cluster_1687115220_4075599846,730,732,2
car6.139,DEFAULT_VEHTYPE,36635979,665,732,67
car6.140,DEFAULT_VEHTYPE,36635979,665,732,67
car2.111,DEFAULT_VEHTYPE,852777135,696,733,37
car2.112,DEFAULT_VEHTYPE,852777135,694,733,39
car2.131,DEFAULT_VEHTYPE,cluster_1832615131_4075599903_5942692697_5942692700,665,733,68
car4.52,DEFAULT_VEHTYPE,cluster_1687115220_4075599846,731,733,2
car3.67,DEFAULT_VEHTYPE,1686594171,694,734,40
car4.55,DEFAULT_VEHTYPE,cluster_1687115220_4075599846,733,734,1
car4.74,DEFAULT_VEHTYPE,cluster_1687115220_4075599846,716,734,18
car3.163,DEFAULT_VEHTYPE,122763218,734,735,1
car3.152,DEFAULT_VEHTYPE,122763218,702,736,34
car4.91,DEFAULT_VEHTYPE,20827734,647,736,89
car5.25,DEFAULT_VEHTYPE,32581278,704,736,32
car1.144,DEFAULT_VEHTYPE,36635976,696,738,42
car6.118,DEFAULT_VEHTYPE,122763207,732,738,6
car6.121,DEFAULT_VEHTYPE,122763207,735,738,3
car6.123,DEFAULT_VEHTYPE,122763207,737,738,1
car6.124,DEFAULT_VEHTYPE,122763207,733,738,5
car6.125,DEFAULT_VEHTYPE,GS_cluster_18314684_1833694981,736,738,2
car6.126,DEFAULT_VEHTYPE,GS_cluster_18314684_1833694981,731,738,7
car3.164,DEFAULT_VEHTYPE,122763218,738,739,1
car5.42,DEFAULT_VEHTYPE,122574871,664,739,75
car6.127,DEFAULT_VEHTYPE,GS_cluster_18314684_1833694981,737,739,2
car6.128,DEFAULT_VEHTYPE,GS_cluster_18314684_1833694981,733,739,6
car1.138,DEFAULT_VEHTYPE,36635976,708,740,32
car4.39,DEFAULT_VEHTYPE,1686594183,735,740,5
car4.41,DEFAULT_VEHTYPE,cluster_1687115220_4075599846,727,740,13
car4.42,DEFAULT_VEHTYPE,1686594183,735,740,5
car4.46,DEFAULT_VEHTYPE,1686594183,736,740,4
car4.49,DEFAULT_VEHTYPE,1686594183,729,740,11
car4.54,DEFAULT_VEHTYPE,cluster_1687115220_4075599846,716,740,24
car4.55,DEFAULT_VEHTYPE,cluster_1687115220_4075599846,735,740,5
car4.60,DEFAULT_VEHTYPE,1686594183,726,740,14
car4.63,DEFAULT_VEHTYPE,1686594183,729,740,11
car4.69,DEFAULT_VEHTYPE,cluster_1687115220_4075599846,739,740,1
car4.74,DEFAULT_VEHTYPE,cluster_1687115220_4075599846,738,740,2
car5.49,DEFAULT_VEHTYPE,122865866,666,740,74
car6.100,DEFAULT_VEHTYPE,16218739,738,740,2
car6.105,DEFAULT_VEHTYPE,16218739,738,740,2
car6.106,DEFAULT_VEHTYPE,16218739,737,740,3
car6.109,DEFAULT_VEHTYPE,16218739,736,740,4
car6.94,DEFAULT_VEHTYPE,16218739,720,740,20
car1.150,DEFAULT_VEHTYPE,852777135,700,741,41
car1.123,DEFAULT_VEHTYPE,11331520849,721,742,21
car1.124,DEFAULT_VEHTYPE,11331520849,725,742,17
car1.125,DEFAULT_VEHTYPE,11331520849,722,742,20
car1.126,DEFAULT_VEHTYPE,11331520849,726,742,16
car2.151,DEFAULT_VEHTYPE,36635968,707,743,36
car3.161,DEFAULT_VEHTYPE,122763218,741,743,2
car4.144,DEFAULT_VEHTYPE,3769264120,736,743,7
car4.146,DEFAULT_VEHTYPE,3769264120,737,743,6
car4.147,DEFAULT_VEHTYPE,3769264120,738,743,5
car4.148,DEFAULT_VEHTYPE,3769264120,737,743,6
car4.149,DEFAULT_VEHTYPE,3769264120,739,743,4
car4.150,DEFAULT_VEHTYPE,3769264120,739,743,4
car4.151,DEFAULT_VEHTYPE,3769264120,739,743,4
car4.152,DEFAULT_VEHTYPE,3769264120,742,743,1
car4.153,DEFAULT_VEHTYPE,3769264120,742,743,1
car6.125,DEFAULT_VEHTYPE,GS_cluster_18314684_1833694981,742,743,1
car3.130,DEFAULT_VEHTYPE,122830043,693,744,51
car1.148,DEFAULT_VEHTYPE,852777135,695,745,50
car6.116,DEFAULT_VEHTYPE,GS_cluster_18314684_1833694981,689,745,56
car6.117,DEFAULT_VEHTYPE,122763207,730,745,15
car1.91,DEFAULT_VEHTYPE,36635968,735,746,11
car1.93,DEFAULT_VEHTYPE,36635968,738,746,8
car1.98,DEFAULT_VEHTYPE,36635968,743,746,3
car2.150,DEFAULT_VEHTYPE,36635968,706,747,41
car4.141,DEFAULT_VEHTYPE,123160863,721,747,26
car3.152,DEFAULT_VEHTYPE,1686594173,742,749,7
car3.153,DEFAULT_VEHTYPE,1686594173,744,749,5
car3.154,DEFAULT_VEHTYPE,1686594173,747,749,2
car3.94,DEFAULT_VEHTYPE,cluster_14963716_27976732_3892769467,713,749,36
car3.95,DEFAULT_VEHTYPE,cluster_14963716_27976732_3892769467,717,749,32
car4.71,DEFAULT_VEHTYPE,14963731,734,750,16
car6.129,DEFAULT_VEHTYPE,GS_cluster_18314684_1833694981,750,751,1
car4.142,DEFAULT_VEHTYPE,3769264120,735,752,17
car4.143,DEFAULT_VEHTYPE,3769264120,735,752,17
car4.145,DEFAULT_VEHTYPE,3769264120,736,752,16
car4.71,DEFAULT_VEHTYPE,14963731,751,752,1
car3.167,DEFAULT_VEHTYPE,122763218,752,753,1
car6.131,DEFAULT_VEHTYPE,GS_cluster_18314684_1833694981,748,753,5
car1.131,DEFAULT_VEHTYPE,122865866,706,754,48
car1.133,DEFAULT_VEHTYPE,122865866,707,754,47
car1.135,DEFAULT_VEHTYPE,122865866,709,754,45
car1.136,DEFAULT_VEHTYPE,122865866,709,754,45
car1.137,DEFAULT_VEHTYPE,122865866,711,754,43
car1.139,DEFAULT_VEHTYPE,122865866,710,754,44
car1.140,DEFAULT_VEHTYPE,122865866,723,754,31
car1.142,DEFAULT_VEHTYPE,122865866,723,754,31
car2.117,DEFAULT_VEHTYPE,122865866,710,754,44
car2.120,DEFAULT_VEHTYPE,122865866,719,754,35
car2.123,DEFAULT_VEHTYPE,122865866,717,754,37
car2.124,DEFAULT_VEHTYPE,122865866,713,754,41
car2.125,DEFAULT_VEHTYPE,122865866,716,754,38
car2.130,DEFAULT_VEHTYPE,122865866,719,754,35
car1.157,DEFAULT_VEHTYPE,36635979,723,756,33
car1.158,DEFAULT_VEHTYPE,36635979,726,756,30
car1.159,DEFAULT_VEHTYPE,36635979,731,756,25
car1.160,DEFAULT_VEHTYPE,36635979,734,756,22
car1.161,DEFAULT_VEHTYPE,36635979,738,756,18
car1.163,DEFAULT_VEHTYPE,36635979,747,756,9
car2.103,DEFAULT_VEHTYPE,36635979,740,756,16
car2.107,DEFAULT_VEHTYPE,36635979,742,756,14
car2.108,DEFAULT_VEHTYPE,36635979,741,756,15
car2.114,DEFAULT_VEHTYPE,36635979,743,756,13
car6.132,DEFAULT_VEHTYPE,GS_cluster_18314684_1833694981,755,756,1
car3.168,DEFAULT_VEHTYPE,122763218,756,757,1
car6.124,DEFAULT_VEHTYPE,122763204,756,757,1
car3.163,DEFAULT_VEHTYPE,122763218,753,759,6
car3.164,DEFAULT_VEHTYPE,122763218,755,759,4
car4.104,DEFAULT_VEHTYPE,20827734,738,759,21
car4.112,DEFAULT_VEHTYPE,20827734,739,759,20
car4.116,DEFAULT_VEHTYPE,20827734,740,760,20
car1.100,DEFAULT_VEHTYPE,36635968,742,761,19
car1.103,DEFAULT_VEHTYPE,36635968,745,761,16
car1.104,DEFAULT_VEHTYPE,36635968,747,761,14
car1.95,DEFAULT_VEHTYPE,36635968,737,761,24
car1.96,DEFAULT_VEHTYPE,36635968,739,761,22
car2.161,DEFAULT_VEHTYPE,36635968,753,761,8
car6.117,DEFAULT_VEHTYPE,122763204,751,764,13
car1.156,DEFAULT_VEHTYPE,36635979,718,765,47
car6.118,DEFAULT_VEHTYPE,122763204,754,765,11
car1.155,DEFAULT_VEHTYPE,36635979,712,766,54
car4.45,DEFAULT_VEHTYPE,1686594183,725,766,41
