vehicle_id,vehicle_type,tls_id,wait_start_time,wait_end_time,wait_duration
1,DEFAULT_VEHTYPE,GS_cluster_123583539_939854594,2,3,1
12,DEFAULT_VEHTYPE,122960160,24,25,1
t1B3-b2739-sl4.0,bus,GS_cluster_444570416_7059565461,29,35,6
23,DEFAULT_VEHTYPE,GS_cluster_444570416_7059565461,61,62,1
t1B3-b2739-sl4.0,bus,cluster_322079583_7059565429_7059565430_7059565458,65,72,7
15,DEFAULT_VEHTYPE,123155447,63,78,15
17,DEFAULT_VEHTYPE,5703666296,63,97,34
49,DEFAULT_VEHTYPE,cluster_268162626_7464757606_939854537,98,99,1
t1B3-b2739-sl4.0,bus,cluster_461492468_7059565454,102,111,9
57,DEFAULT_VEHTYPE,122793092,114,115,1
64,DEFAULT_VEHTYPE,cluster_322079583_7059565429_7059565430_7059565458,128,129,1
13,DEFAULT_VEHTYPE,122793092,55,144,89
76,DEFAULT_VEHTYPE,123155447,152,153,1
48,DEFAULT_VEHTYPE,cluster_322079583_7059565429_7059565430_7059565458,137,167,30
1,DEFAULT_VEHTYPE,GS_cluster_343596914_939854645,81,169,88
64,DEFAULT_VEHTYPE,cluster_461492468_7059565454,157,171,14
4,DEFAULT_VEHTYPE,123155447,53,173,120
92,DEFAULT_VEHTYPE,1166628271,184,185,1
2,DEFAULT_VEHTYPE,122793092,148,196,48
t163-b2736-sl4.0,bus,1166628271,188,199,11
75,DEFAULT_VEHTYPE,5703666296,169,204,35
26,DEFAULT_VEHTYPE,123155447,201,205,4
61,DEFAULT_VEHTYPE,GS_cluster_343596914_939854645,192,206,14
12,DEFAULT_VEHTYPE,cluster_11500662930_268161351_268161547,205,213,8
107,DEFAULT_VEHTYPE,122960160,214,215,1
110,DEFAULT_VEHTYPE,122804862,220,221,1
58,DEFAULT_VEHTYPE,cluster_322079583_7059565429_7059565430_7059565458,200,228,28
36,DEFAULT_VEHTYPE,GS_cluster_343596914_939854645,228,234,6
118,DEFAULT_VEHTYPE,GS_cluster_123583539_939854594,236,237,1
57,DEFAULT_VEHTYPE,cluster_122966911_7059565450,199,237,38
29,DEFAULT_VEHTYPE,GS_cluster_343596914_939854645,145,240,95
100,DEFAULT_VEHTYPE,122804862,215,245,30
38,DEFAULT_VEHTYPE,cluster_11500662930_268161351_268161547,222,245,23
104,DEFAULT_VEHTYPE,5703666296,235,252,17
96,DEFAULT_VEHTYPE,2030551464,232,252,20
101,DEFAULT_VEHTYPE,GS_1166628306,246,257,11
t1B3-b2739-sl4.0,bus,GS_cluster_268161414_5950715985,250,257,7
49,DEFAULT_VEHTYPE,2030551464,169,268,99
85,DEFAULT_VEHTYPE,5703666296,231,275,44
t1B3-b2739-sl4.0,bus,GS_cluster_268161414_5950715985,263,275,12
101,DEFAULT_VEHTYPE,268161337,277,283,6
83,DEFAULT_VEHTYPE,GS_cluster_343596914_939854645,201,285,84
57,DEFAULT_VEHTYPE,cluster_461492468_7059565454,241,287,46
11,DEFAULT_VEHTYPE,GS_cluster_343596914_939854645,297,305,8
110,DEFAULT_VEHTYPE,GS_cluster_268161414_5950715985,295,305,10
15,DEFAULT_VEHTYPE,GS_cluster_343596914_939854645,297,305,8
34,DEFAULT_VEHTYPE,GS_cluster_343596914_939854645,281,305,24
37,DEFAULT_VEHTYPE,GS_cluster_343596914_939854645,295,305,10
45,DEFAULT_VEHTYPE,GS_cluster_343596914_939854645,278,305,27
66,DEFAULT_VEHTYPE,GS_cluster_343596914_939854645,290,305,15
67,DEFAULT_VEHTYPE,GS_cluster_343596914_939854645,296,305,9
71,DEFAULT_VEHTYPE,268161337,304,312,8
t1B3-b2739-sl4.0,bus,2030551464,300,314,14
94,DEFAULT_VEHTYPE,5703666296,289,318,29
100,DEFAULT_VEHTYPE,GS_cluster_268161414_5950715985,290,321,31
50,DEFAULT_VEHTYPE,GS_cluster_7059565448_7059565449_7464757604_939854561,273,330,57
24,DEFAULT_VEHTYPE,268161552,329,332,3
4,DEFAULT_VEHTYPE,GS_cluster_343596914_939854645,276,333,57
17,DEFAULT_VEHTYPE,cluster_11500662930_268161351_268161547,294,334,40
21,DEFAULT_VEHTYPE,GS_cluster_7059565448_7059565449_7464757604_939854561,310,335,25
9,DEFAULT_VEHTYPE,GS_cluster_343596914_939854645,269,337,68
30,DEFAULT_VEHTYPE,cluster_11500662930_268161351_268161547,241,339,98
42,DEFAULT_VEHTYPE,cluster_11500662930_268161351_268161547,266,339,73
49,DEFAULT_VEHTYPE,cluster_11500662930_268161351_268161547,272,339,67
25,DEFAULT_VEHTYPE,GS_cluster_343596914_939854645,327,341,14
133,DEFAULT_VEHTYPE,5703666296,320,348,28
17,DEFAULT_VEHTYPE,cluster_11500662930_268161351_268161547,338,358,20
102,DEFAULT_VEHTYPE,GS_cluster_343596914_939854645,348,362,14
88,DEFAULT_VEHTYPE,GS_cluster_7059565448_7059565449_7464757604_939854561,244,362,118
182,DEFAULT_VEHTYPE,122804862,364,365,1
118,DEFAULT_VEHTYPE,GS_cluster_343596914_939854645,288,367,79
154,DEFAULT_VEHTYPE,123155447,356,371,15
111,DEFAULT_VEHTYPE,GS_cluster_7059565448_7059565449_7464757604_939854561,372,377,5
150,DEFAULT_VEHTYPE,GS_cluster_268161414_5950715985,348,379,31
139,DEFAULT_VEHTYPE,GS_cluster_123583539_939854594,340,383,43
192,DEFAULT_VEHTYPE,1166628271,384,385,1
118,DEFAULT_VEHTYPE,cluster_11500662930_268161351_268161547,371,391,20
121,DEFAULT_VEHTYPE,cluster_11500662930_268161351_268161547,382,391,9
t163-b2736-sl4.0,bus,cluster_11500662930_268161351_268161547,384,393,9
139,DEFAULT_VEHTYPE,GS_cluster_7059565448_7059565449_7464757604_939854561,388,398,10
t163-b2736-sl4.0,bus,cluster_11500662930_268161351_268161547,394,404,10
48,DEFAULT_VEHTYPE,2030551464,307,409,102
112,DEFAULT_VEHTYPE,cluster_11500662930_268161351_268161547,410,414,4
155,DEFAULT_VEHTYPE,cluster_11500662930_268161351_268161547,408,414,6
4,DEFAULT_VEHTYPE,GS_cluster_7059565448_7059565449_7464757604_939854561,365,414,49
100,DEFAULT_VEHTYPE,2030551464,325,415,90
110,DEFAULT_VEHTYPE,2030551464,327,419,92
40,DEFAULT_VEHTYPE,GS_cluster_343596914_939854645,412,421,9
100,DEFAULT_VEHTYPE,cluster_11500662930_268161351_268161547,419,424,5
110,DEFAULT_VEHTYPE,cluster_11500662930_268161351_268161547,422,424,2
48,DEFAULT_VEHTYPE,cluster_11500662930_268161351_268161547,413,424,11
t163-b2736-sl4.0,bus,cluster_11500662930_268161351_268161547,406,424,18
116,DEFAULT_VEHTYPE,GS_cluster_343596914_939854645,344,426,82
21,DEFAULT_VEHTYPE,cluster_322079583_7059565429_7059565430_7059565458,392,426,34
175,DEFAULT_VEHTYPE,5703666296,392,428,36
157,DEFAULT_VEHTYPE,GS_cluster_7059565448_7059565449_7464757604_939854561,367,431,64
118,DEFAULT_VEHTYPE,268161552,422,433,11
121,DEFAULT_VEHTYPE,268161552,427,433,6
66,DEFAULT_VEHTYPE,268161552,432,433,1
100,DEFAULT_VEHTYPE,cluster_11500662930_268161351_268161547,425,436,11
110,DEFAULT_VEHTYPE,cluster_11500662930_268161351_268161547,425,436,11
48,DEFAULT_VEHTYPE,cluster_11500662930_268161351_268161547,425,436,11
t163-b2736-sl4.0,bus,cluster_11500662930_268161351_268161547,425,436,11
t1B3-b2739-sl4.0,bus,cluster_11500662930_268161351_268161547,433,436,3
142,DEFAULT_VEHTYPE,122793100,373,440,67
205,DEFAULT_VEHTYPE,GS_1166628306,426,441,15
168,DEFAULT_VEHTYPE,GS_1166628306,429,442,13
142,DEFAULT_VEHTYPE,122793092,442,443,1
185,DEFAULT_VEHTYPE,122793092,422,443,21
67,DEFAULT_VEHTYPE,268161552,440,444,4
102,DEFAULT_VEHTYPE,cluster_11500662930_268161351_268161547,435,449,14
116,DEFAULT_VEHTYPE,cluster_11500662930_268161351_268161547,430,449,19
135,DEFAULT_VEHTYPE,GS_cluster_343596914_939854645,400,449,49
71,DEFAULT_VEHTYPE,GS_cluster_343596914_939854645,399,449,50
156,DEFAULT_VEHTYPE,2030551464,358,455,97
156,DEFAULT_VEHTYPE,cluster_11500662930_268161351_268161547,460,465,5
197,DEFAULT_VEHTYPE,GS_cluster_7059565448_7059565449_7464757604_939854561,424,465,41
163,DEFAULT_VEHTYPE,cluster_268162626_7464757606_939854537,426,466,40
150,DEFAULT_VEHTYPE,2030551464,383,473,90
139,DEFAULT_VEHTYPE,122804862,449,474,25
33,DEFAULT_VEHTYPE,GS_cluster_7059565448_7059565449_7464757604_939854561,425,478,53
101,DEFAULT_VEHTYPE,GS_cluster_7059565448_7059565449_7464757604_939854561,426,479,53
239,DEFAULT_VEHTYPE,cluster_1166628477_2761920333,478,479,1
5,DEFAULT_VEHTYPE,GS_cluster_444570416_7059565461,439,480,41
160,DEFAULT_VEHTYPE,123155447,474,483,9
210,DEFAULT_VEHTYPE,123155447,472,483,11
174,DEFAULT_VEHTYPE,GS_cluster_343596914_939854645,410,486,76
102,DEFAULT_VEHTYPE,268161552,483,493,10
114,DEFAULT_VEHTYPE,268161552,487,493,6
116,DEFAULT_VEHTYPE,268161552,478,493,15
178,DEFAULT_VEHTYPE,268161337,487,494,7
205,DEFAULT_VEHTYPE,268161552,448,495,47
200,DEFAULT_VEHTYPE,cluster_11500662930_268161351_268161547,470,496,26
169,DEFAULT_VEHTYPE,2030551464,399,505,106
172,DEFAULT_VEHTYPE,268161337,504,508,4
184,DEFAULT_VEHTYPE,2030551464,426,514,88
109,DEFAULT_VEHTYPE,GS_cluster_343596914_939854645,505,515,10
131,DEFAULT_VEHTYPE,GS_cluster_343596914_939854645,503,515,12
150,DEFAULT_VEHTYPE,cluster_11500662930_268161351_268161547,477,529,52
169,DEFAULT_VEHTYPE,cluster_11500662930_268161351_268161547,508,529,21
184,DEFAULT_VEHTYPE,cluster_11500662930_268161351_268161547,519,529,10
224,DEFAULT_VEHTYPE,cluster_11500662930_268161351_268161547,522,529,7
247,DEFAULT_VEHTYPE,GS_cluster_268161414_5950715985,527,535,8
71,DEFAULT_VEHTYPE,GS_cluster_7059565448_7059565449_7464757604_939854561,481,535,54
140,DEFAULT_VEHTYPE,cluster_11500662930_268161351_268161547,520,537,17
241,DEFAULT_VEHTYPE,cluster_11500662930_268161351_268161547,529,537,8
182,DEFAULT_VEHTYPE,2030551464,454,538,84
101,DEFAULT_VEHTYPE,5703666296,538,539,1
159,DEFAULT_VEHTYPE,GS_1166628306,514,539,25
147,DEFAULT_VEHTYPE,122793092,475,542,67
84,DEFAULT_VEHTYPE,GS_cluster_343596914_939854645,443,544,101
95,DEFAULT_VEHTYPE,GS_cluster_343596914_939854645,466,545,79
199,DEFAULT_VEHTYPE,122793092,540,546,6
216,DEFAULT_VEHTYPE,5703666296,534,562,28
231,DEFAULT_VEHTYPE,GS_cluster_123583539_939854594,522,565,43
219,DEFAULT_VEHTYPE,GS_cluster_268161414_5950715985,542,566,24
186,DEFAULT_VEHTYPE,GS_cluster_122793088_856214935,550,573,23
149,DEFAULT_VEHTYPE,GS_cluster_343596914_939854645,563,574,11
231,DEFAULT_VEHTYPE,GS_cluster_343596914_939854645,569,574,5
264,DEFAULT_VEHTYPE,GS_cluster_343596914_939854645,564,574,10
232,DEFAULT_VEHTYPE,GS_cluster_122793088_856214935,575,578,3
236,DEFAULT_VEHTYPE,123155447,550,581,31
182,DEFAULT_VEHTYPE,cluster_11500662930_268161351_268161547,543,582,39
154,DEFAULT_VEHTYPE,cluster_1166628477_2761920333,528,586,58
253,DEFAULT_VEHTYPE,cluster_268162626_7464757606_939854537,542,586,44
204,DEFAULT_VEHTYPE,GS_cluster_343596914_939854645,503,588,85
276,DEFAULT_VEHTYPE,5703666296,567,601,34
165,DEFAULT_VEHTYPE,GS_cluster_343596914_939854645,535,602,67
204,DEFAULT_VEHTYPE,cluster_11500662930_268161351_268161547,593,607,14
211,DEFAULT_VEHTYPE,GS_cluster_122793088_856214935,587,609,22
279,DEFAULT_VEHTYPE,cluster_268162626_7464757606_939854537,573,609,36
187,DEFAULT_VEHTYPE,1166628271,615,616,1
267,DEFAULT_VEHTYPE,123155447,591,619,28
311,DEFAULT_VEHTYPE,5703666296,622,623,1
187,DEFAULT_VEHTYPE,1166628271,624,625,1
175,DEFAULT_VEHTYPE,2030551464,525,627,102
199,DEFAULT_VEHTYPE,GS_cluster_343596914_939854645,597,631,34
211,DEFAULT_VEHTYPE,GS_cluster_343596914_939854645,612,631,19
232,DEFAULT_VEHTYPE,GS_cluster_343596914_939854645,594,631,37
196,DEFAULT_VEHTYPE,GS_cluster_343596914_939854645,559,638,79
196,DEFAULT_VEHTYPE,cluster_11500662930_268161351_268161547,643,647,4
231,DEFAULT_VEHTYPE,cluster_11500662930_268161351_268161547,646,647,1
215,DEFAULT_VEHTYPE,GS_cluster_343596914_939854645,647,650,3
175,DEFAULT_VEHTYPE,cluster_11500662930_268161351_268161547,631,652,21
281,DEFAULT_VEHTYPE,123155447,626,652,26
218,DEFAULT_VEHTYPE,1166628271,639,653,14
248,DEFAULT_VEHTYPE,cluster_268162626_7464757606_939854537,615,653,38
259,DEFAULT_VEHTYPE,GS_cluster_343596914_939854645,554,656,102
290,DEFAULT_VEHTYPE,GS_cluster_123583539_939854594,610,660,50
285,DEFAULT_VEHTYPE,GS_cluster_123583539_939854594,610,662,52
109,DEFAULT_VEHTYPE,122793092,559,663,104
331,DEFAULT_VEHTYPE,GS_cluster_444570416_7059565461,662,663,1
216,DEFAULT_VEHTYPE,GS_cluster_268161414_5950715985,632,672,40
270,DEFAULT_VEHTYPE,GS_cluster_343596914_939854645,649,679,30
288,DEFAULT_VEHTYPE,122793092,629,679,50
159,DEFAULT_VEHTYPE,GS_cluster_343596914_939854645,616,680,64
164,DEFAULT_VEHTYPE,cluster_461492468_7059565454,632,680,48
95,DEFAULT_VEHTYPE,cluster_461492468_7059565454,638,682,44
219,DEFAULT_VEHTYPE,cluster_11500662930_268161351_268161547,663,689,26
253,DEFAULT_VEHTYPE,cluster_11500662930_268161351_268161547,683,689,6
282,DEFAULT_VEHTYPE,cluster_11500662930_268161351_268161547,669,689,20
323,DEFAULT_VEHTYPE,cluster_322079583_7059565429_7059565430_7059565458,670,692,22
273,DEFAULT_VEHTYPE,2030551464,597,694,97
252,DEFAULT_VEHTYPE,GS_cluster_7059565448_7059565449_7464757604_939854561,620,697,77
269,DEFAULT_VEHTYPE,GS_cluster_343596914_939854645,687,697,10
320,DEFAULT_VEHTYPE,GS_cluster_268161414_5950715985,674,698,24
223,DEFAULT_VEHTYPE,cluster_11500662930_268161351_268161547,700,701,1
291,DEFAULT_VEHTYPE,cluster_11500662930_268161351_268161547,619,703,84
351,DEFAULT_VEHTYPE,cluster_11500662930_268161351_268161547,702,703,1
301,DEFAULT_VEHTYPE,123284068,688,706,18
186,DEFAULT_VEHTYPE,GS_cluster_343596914_939854645,578,709,131
288,DEFAULT_VEHTYPE,GS_cluster_343596914_939854645,698,709,11
286,DEFAULT_VEHTYPE,cluster_122966911_7059565450,662,710,48
263,DEFAULT_VEHTYPE,268161337,624,711,87
322,DEFAULT_VEHTYPE,cluster_322079583_7059565429_7059565430_7059565458,689,714,25
274,DEFAULT_VEHTYPE,GS_cluster_343596914_939854645,629,715,86
331,DEFAULT_VEHTYPE,cluster_322079583_7059565429_7059565430_7059565458,692,716,24
164,DEFAULT_VEHTYPE,cluster_322079583_7059565429_7059565430_7059565458,684,717,33
201,DEFAULT_VEHTYPE,GS_cluster_343596914_939854645,704,717,13
208,DEFAULT_VEHTYPE,GS_cluster_343596914_939854645,714,717,3
237,DEFAULT_VEHTYPE,GS_cluster_343596914_939854645,702,717,15
263,DEFAULT_VEHTYPE,GS_cluster_343596914_939854645,716,717,1
276,DEFAULT_VEHTYPE,GS_cluster_268161414_5950715985,678,717,39
291,DEFAULT_VEHTYPE,GS_cluster_343596914_939854645,708,717,9
293,DEFAULT_VEHTYPE,GS_cluster_343596914_939854645,704,717,13
334,DEFAULT_VEHTYPE,GS_cluster_343596914_939854645,716,717,1
95,DEFAULT_VEHTYPE,cluster_322079583_7059565429_7059565430_7059565458,686,719,33
214,DEFAULT_VEHTYPE,GS_cluster_268161414_5950715985,666,720,54
292,DEFAULT_VEHTYPE,2030551464,621,725,104
319,DEFAULT_VEHTYPE,123155447,716,725,9
213,DEFAULT_VEHTYPE,GS_cluster_122793088_856214935,682,728,46
