vehicle_id,vehicle_type,tls_id,wait_start_time,wait_end_time,wait_duration
f_0.4,DEFAULT_VEHTYPE,123195735,13,14,1
f_0.5,DEFAULT_VEHTYPE,123195735,16,17,1
bus1,bus,GS_cluster_268161174_339357038,21,24,3
car4.0,DEFAULT_VEHTYPE,123322168,26,28,2
f_0.4,DEFAULT_VEHTYPE,123195735,19,35,16
f_0.5,DEFAULT_VEHTYPE,123195735,21,35,14
bus2,bus,123322168,26,46,20
f_0.1,DEFAULT_VEHTYPE,123467582,24,48,24
f_0.2,DEFAULT_VEHTYPE,123467582,26,49,23
f_0.9,DEFAULT_VEHTYPE,123195735,48,49,1
car3.1,DEFAULT_VEHTYPE,GS_cluster_122690801_3137460781,35,50,15
f_0.3,DEFAULT_VEHTYPE,123195735,17,51,34
f_0.10,DEFAULT_VEHTYPE,123195735,51,52,1
f_0.0,DEFAULT_VEHTYPE,123467582,20,68,48
car3.0,DEFAULT_VEHTYPE,GS_cluster_122690801_3137460781,32,70,38
f_0.10,DEFAULT_VEHTYPE,123195735,56,70,14
f_0.9,DEFAULT_VEHTYPE,123195735,54,70,16
car2.1,DEFAULT_VEHTYPE,122837337,67,74,7
f_0.1,DEFAULT_VEHTYPE,123467582,52,79,27
f_0.8,DEFAULT_VEHTYPE,123195735,52,83,31
car4.0,DEFAULT_VEHTYPE,36750787,81,84,3
car4.6,DEFAULT_VEHTYPE,123322168,48,84,36
car4.7,DEFAULT_VEHTYPE,123322168,53,84,31
car4.8,DEFAULT_VEHTYPE,123322168,55,84,29
car4.9,DEFAULT_VEHTYPE,123322168,58,84,26
car3.1,DEFAULT_VEHTYPE,268162734,76,86,10
f_0.15,DEFAULT_VEHTYPE,123195735,85,86,1
f_0.1,DEFAULT_VEHTYPE,123322168,87,88,1
f_0.8,DEFAULT_VEHTYPE,123467582,88,97,9
f_0.9,DEFAULT_VEHTYPE,123467582,89,98,9
f_0.14,DEFAULT_VEHTYPE,123195735,89,105,16
f_0.15,DEFAULT_VEHTYPE,123195735,90,105,15
car3.0,DEFAULT_VEHTYPE,268162734,74,116,42
f_0.10,DEFAULT_VEHTYPE,123467582,105,117,12
f_0.9,DEFAULT_VEHTYPE,123467582,103,117,14
f_0.19,DEFAULT_VEHTYPE,123195735,118,119,1
bus2,bus,123284038,79,120,41
f_0.20,DEFAULT_VEHTYPE,123195735,121,122,1
bus2,bus,122837337,123,127,4
car4.10,DEFAULT_VEHTYPE,123322168,98,127,29
car4.11,DEFAULT_VEHTYPE,123322168,100,127,27
car4.8,DEFAULT_VEHTYPE,123322168,94,127,33
car4.9,DEFAULT_VEHTYPE,123322168,96,127,31
f_0.13,DEFAULT_VEHTYPE,123195735,86,127,41
f_0.6,DEFAULT_VEHTYPE,123322168,105,128,23
f_0.7,DEFAULT_VEHTYPE,123467582,70,130,60
car3.17,DEFAULT_VEHTYPE,GS_cluster_122690801_3137460781,93,132,39
f_0.8,DEFAULT_VEHTYPE,123467582,100,132,32
car4.5,DEFAULT_VEHTYPE,123322168,46,134,88
bus1,bus,36750787,130,136,6
f_0.19,DEFAULT_VEHTYPE,123195735,123,140,17
f_0.20,DEFAULT_VEHTYPE,123195735,126,140,14
car4.5,DEFAULT_VEHTYPE,36750787,138,144,6
car4.6,DEFAULT_VEHTYPE,36750787,141,144,3
car2.14,DEFAULT_VEHTYPE,122837337,111,149,38
car3.5,DEFAULT_VEHTYPE,36750787,147,150,3
f_0.18,DEFAULT_VEHTYPE,123195735,121,153,32
f_0.24,DEFAULT_VEHTYPE,123195735,153,154,1
f_0.25,DEFAULT_VEHTYPE,123195735,156,157,1
bus2,bus,268162734,168,172,4
f_0.24,DEFAULT_VEHTYPE,123195735,159,175,16
f_0.25,DEFAULT_VEHTYPE,123195735,160,175,15
car4.7,DEFAULT_VEHTYPE,123322168,92,177,85
car3.16,DEFAULT_VEHTYPE,GS_cluster_122690801_3137460781,89,178,89
f_0.8,DEFAULT_VEHTYPE,123322168,154,180,26
f_0.9,DEFAULT_VEHTYPE,123322168,155,180,25
f_0.10,DEFAULT_VEHTYPE,123322168,157,181,24
f_0.11,DEFAULT_VEHTYPE,123322168,159,182,23
f_0.12,DEFAULT_VEHTYPE,123322168,161,183,22
f_0.13,DEFAULT_VEHTYPE,123322168,163,183,20
f_0.14,DEFAULT_VEHTYPE,123322168,164,183,19
f_0.15,DEFAULT_VEHTYPE,123322168,165,183,18
f_0.7,DEFAULT_VEHTYPE,123322168,147,183,36
car3.28,DEFAULT_VEHTYPE,268162734,178,185,7
f_0.19,DEFAULT_VEHTYPE,123467582,160,185,25
f_0.20,DEFAULT_VEHTYPE,123467582,162,185,23
f_0.29,DEFAULT_VEHTYPE,123195735,188,189,1
f_0.30,DEFAULT_VEHTYPE,123195735,191,192,1
car4.6,DEFAULT_VEHTYPE,36750787,145,193,48
car4.7,DEFAULT_VEHTYPE,36750787,180,193,13
f_0.23,DEFAULT_VEHTYPE,123195735,156,194,38
f_0.18,DEFAULT_VEHTYPE,123467582,158,201,43
f_0.29,DEFAULT_VEHTYPE,123195735,195,210,15
f_0.30,DEFAULT_VEHTYPE,123195735,197,210,13
f_0.28,DEFAULT_VEHTYPE,123195735,193,224,31
f_0.34,DEFAULT_VEHTYPE,123195735,223,224,1
car3.43,DEFAULT_VEHTYPE,GS_cluster_122690801_3137460781,189,227,38
f_0.35,DEFAULT_VEHTYPE,123195735,226,227,1
f_0.28,DEFAULT_VEHTYPE,123467582,228,233,5
f_0.29,DEFAULT_VEHTYPE,123467582,229,234,5
car4.36,DEFAULT_VEHTYPE,123322168,186,236,50
car4.37,DEFAULT_VEHTYPE,123322168,187,236,49
car4.38,DEFAULT_VEHTYPE,123322168,188,236,48
car4.39,DEFAULT_VEHTYPE,123322168,191,236,45
f_0.29,DEFAULT_VEHTYPE,123467582,240,244,4
f_0.30,DEFAULT_VEHTYPE,123467582,241,244,3
car3.42,DEFAULT_VEHTYPE,GS_cluster_122690801_3137460781,187,245,58
f_0.34,DEFAULT_VEHTYPE,123195735,228,245,17
f_0.35,DEFAULT_VEHTYPE,123195735,230,245,15
f_0.18,DEFAULT_VEHTYPE,123322168,222,247,25
f_0.20,DEFAULT_VEHTYPE,123322168,225,247,22
f_0.21,DEFAULT_VEHTYPE,123322168,227,248,21
f_0.22,DEFAULT_VEHTYPE,123322168,229,249,20
f_0.23,DEFAULT_VEHTYPE,123322168,230,250,20
f_0.24,DEFAULT_VEHTYPE,123322168,232,251,19
f_0.25,DEFAULT_VEHTYPE,123322168,233,252,19
f_0.26,DEFAULT_VEHTYPE,123322168,235,253,18
f_0.27,DEFAULT_VEHTYPE,123467582,206,257,51
f_0.33,DEFAULT_VEHTYPE,123195735,226,258,32
f_0.28,DEFAULT_VEHTYPE,123467582,238,259,21
f_0.39,DEFAULT_VEHTYPE,123195735,258,259,1
f_0.40,DEFAULT_VEHTYPE,123195735,261,262,1
car3.27,DEFAULT_VEHTYPE,268162734,176,263,87
f_0.28,DEFAULT_VEHTYPE,123284038,263,264,1
f_0.22,DEFAULT_VEHTYPE,123322168,255,271,16
f_0.23,DEFAULT_VEHTYPE,123322168,256,271,15
f_0.24,DEFAULT_VEHTYPE,123322168,258,272,14
bus1,bus,GS_cluster_122690801_3137460781,188,273,85
f_0.25,DEFAULT_VEHTYPE,123322168,259,273,14
f_0.26,DEFAULT_VEHTYPE,123322168,261,274,13
f_0.23,DEFAULT_VEHTYPE,123322168,276,278,2
f_0.24,DEFAULT_VEHTYPE,123322168,277,279,2
f_0.25,DEFAULT_VEHTYPE,123322168,279,280,1
f_0.39,DEFAULT_VEHTYPE,123195735,264,280,16
f_0.40,DEFAULT_VEHTYPE,123195735,265,280,15
car4.35,DEFAULT_VEHTYPE,123322168,181,282,101
f_0.27,DEFAULT_VEHTYPE,123284038,260,283,23
car3.33,DEFAULT_VEHTYPE,36750787,283,284,1
car3.47,DEFAULT_VEHTYPE,268162734,263,284,21
f_0.20,DEFAULT_VEHTYPE,123322168,252,292,40
f_0.21,DEFAULT_VEHTYPE,123322168,254,292,38
f_0.22,DEFAULT_VEHTYPE,123322168,276,292,16
f_0.23,DEFAULT_VEHTYPE,123322168,282,292,10
f_0.24,DEFAULT_VEHTYPE,123322168,283,292,9
f_0.25,DEFAULT_VEHTYPE,123322168,285,292,7
f_0.26,DEFAULT_VEHTYPE,123322168,286,292,6
f_0.27,DEFAULT_VEHTYPE,123322168,289,292,3
f_0.28,DEFAULT_VEHTYPE,123322168,291,292,1
f_0.38,DEFAULT_VEHTYPE,123195735,262,293,31
bus1,bus,123467582,281,294,13
car4.34,DEFAULT_VEHTYPE,36750787,250,294,44
car4.35,DEFAULT_VEHTYPE,36750787,285,294,9
f_0.44,DEFAULT_VEHTYPE,123195735,293,294,1
f_0.45,DEFAULT_VEHTYPE,123195735,296,297,1
car2.50,DEFAULT_VEHTYPE,122837337,274,306,32
f_0.39,DEFAULT_VEHTYPE,123467582,301,310,9
f_0.40,DEFAULT_VEHTYPE,123467582,303,310,7
bus2,bus,cluster_1166628429_12503965554_268161337_268161552,309,311,2
f_0.44,DEFAULT_VEHTYPE,123195735,299,315,16
f_0.45,DEFAULT_VEHTYPE,123195735,300,315,15
car3.68,DEFAULT_VEHTYPE,GS_cluster_122690801_3137460781,285,323,38
f_0.38,DEFAULT_VEHTYPE,123467582,298,323,25
f_0.43,DEFAULT_VEHTYPE,123195735,297,328,31
f_0.49,DEFAULT_VEHTYPE,123195735,328,329,1
f_0.50,DEFAULT_VEHTYPE,123195735,331,332,1
f_0.39,DEFAULT_VEHTYPE,123284038,330,336,6
f_0.40,DEFAULT_VEHTYPE,123284038,332,336,4
bus2,bus,cluster_1166628429_12503965554_268161337_268161552,312,342,30
car3.67,DEFAULT_VEHTYPE,GS_cluster_122690801_3137460781,283,345,62
f_0.49,DEFAULT_VEHTYPE,123195735,334,350,16
f_0.50,DEFAULT_VEHTYPE,123195735,336,350,14
car3.68,DEFAULT_VEHTYPE,268162734,351,355,4
f_0.38,DEFAULT_VEHTYPE,123284038,327,355,28
car4.65,DEFAULT_VEHTYPE,123322168,294,358,64
car4.66,DEFAULT_VEHTYPE,123322168,295,358,63
car4.67,DEFAULT_VEHTYPE,123322168,298,358,60
car4.68,DEFAULT_VEHTYPE,123322168,300,358,58
f_0.44,DEFAULT_VEHTYPE,123467582,335,360,25
f_0.45,DEFAULT_VEHTYPE,123467582,338,360,22
car2.53,DEFAULT_VEHTYPE,122837337,342,361,19
car3.46,DEFAULT_VEHTYPE,268162734,260,362,102
f_0.45,DEFAULT_VEHTYPE,123467582,363,364,1
f_0.54,DEFAULT_VEHTYPE,123195735,363,364,1
f_0.55,DEFAULT_VEHTYPE,123195735,366,367,1
f_0.48,DEFAULT_VEHTYPE,123195735,331,371,40
f_0.43,DEFAULT_VEHTYPE,123467582,333,379,46
f_0.54,DEFAULT_VEHTYPE,123195735,370,385,15
f_0.55,DEFAULT_VEHTYPE,123195735,370,385,15
car4.61,DEFAULT_VEHTYPE,36750787,351,389,38
car4.62,DEFAULT_VEHTYPE,36750787,352,389,37
f_0.39,DEFAULT_VEHTYPE,123322168,365,389,24
f_0.40,DEFAULT_VEHTYPE,123322168,366,389,23
f_0.41,DEFAULT_VEHTYPE,123322168,368,390,22
f_0.42,DEFAULT_VEHTYPE,123322168,369,391,22
f_0.43,DEFAULT_VEHTYPE,123284038,384,398,14
f_0.45,DEFAULT_VEHTYPE,123284038,386,398,12
f_0.53,DEFAULT_VEHTYPE,123195735,367,399,32
f_0.59,DEFAULT_VEHTYPE,123195735,398,399,1
car3.73,DEFAULT_VEHTYPE,268162734,374,401,27
f_0.60,DEFAULT_VEHTYPE,123195735,401,402,1
car4.64,DEFAULT_VEHTYPE,123322168,292,410,118
f_0.53,DEFAULT_VEHTYPE,123467582,403,410,7
f_0.54,DEFAULT_VEHTYPE,123467582,406,411,5
f_0.41,DEFAULT_VEHTYPE,123322168,395,413,18
f_0.42,DEFAULT_VEHTYPE,123322168,396,413,17
f_0.40,DEFAULT_VEHTYPE,123322168,393,414,21
f_0.44,DEFAULT_VEHTYPE,123284038,382,416,34
car3.93,DEFAULT_VEHTYPE,GS_cluster_122690801_3137460781,378,418,40
f_0.59,DEFAULT_VEHTYPE,123195735,404,420,16
f_0.60,DEFAULT_VEHTYPE,123195735,405,420,15
f_0.54,DEFAULT_VEHTYPE,123467582,417,432,15
f_0.55,DEFAULT_VEHTYPE,123467582,418,432,14
f_0.64,DEFAULT_VEHTYPE,123195735,433,434,1
f_0.65,DEFAULT_VEHTYPE,123195735,436,437,1
f_0.58,DEFAULT_VEHTYPE,123195735,402,442,40
f_0.53,DEFAULT_VEHTYPE,123467582,414,445,31
f_0.52,DEFAULT_VEHTYPE,123467582,384,448,64
car2.75,DEFAULT_VEHTYPE,122837337,407,449,42
car4.65,DEFAULT_VEHTYPE,36750787,415,449,34
car4.66,DEFAULT_VEHTYPE,36750787,420,449,29
f_0.64,DEFAULT_VEHTYPE,123195735,438,455,17
f_0.65,DEFAULT_VEHTYPE,123195735,440,455,15
car4.93,DEFAULT_VEHTYPE,123322168,416,463,47
car4.94,DEFAULT_VEHTYPE,123322168,418,463,45
car4.95,DEFAULT_VEHTYPE,123322168,419,463,44
car4.96,DEFAULT_VEHTYPE,123322168,420,463,43
f_0.52,DEFAULT_VEHTYPE,123284038,452,466,14
f_0.54,DEFAULT_VEHTYPE,123284038,453,466,13
f_0.63,DEFAULT_VEHTYPE,123195735,437,469,32
f_0.69,DEFAULT_VEHTYPE,123195735,468,469,1
f_0.70,DEFAULT_VEHTYPE,123195735,471,472,1
car3.91,DEFAULT_VEHTYPE,268162734,446,474,28
car3.92,DEFAULT_VEHTYPE,GS_cluster_122690801_3137460781,377,475,98
f_0.63,DEFAULT_VEHTYPE,123467582,474,478,4
f_0.64,DEFAULT_VEHTYPE,123467582,476,479,3
f_0.53,DEFAULT_VEHTYPE,123284038,450,484,34
f_0.69,DEFAULT_VEHTYPE,123195735,474,490,16
f_0.70,DEFAULT_VEHTYPE,123195735,476,490,14
f_0.64,DEFAULT_VEHTYPE,123467582,485,502,17
f_0.65,DEFAULT_VEHTYPE,123467582,487,502,15
f_0.74,DEFAULT_VEHTYPE,123195735,503,504,1
f_0.75,DEFAULT_VEHTYPE,123195735,506,507,1
car3.67,DEFAULT_VEHTYPE,268162734,349,508,159
car3.116,DEFAULT_VEHTYPE,GS_cluster_122690801_3137460781,472,511,39
f_0.68,DEFAULT_VEHTYPE,123195735,472,512,40
car4.92,DEFAULT_VEHTYPE,123322168,415,514,99
f_0.61,DEFAULT_VEHTYPE,123467582,452,515,63
car3.72,DEFAULT_VEHTYPE,268162734,374,516,142
f_0.63,DEFAULT_VEHTYPE,123467582,482,517,35
f_0.52,DEFAULT_VEHTYPE,123322168,494,519,25
f_0.54,DEFAULT_VEHTYPE,123322168,496,519,23
f_0.55,DEFAULT_VEHTYPE,123322168,497,519,22
f_0.56,DEFAULT_VEHTYPE,123322168,498,519,21
f_0.57,DEFAULT_VEHTYPE,123322168,501,519,18
f_0.58,DEFAULT_VEHTYPE,123322168,505,519,14
f_0.59,DEFAULT_VEHTYPE,123322168,506,519,13
f_0.60,DEFAULT_VEHTYPE,123322168,508,519,11
f_0.62,DEFAULT_VEHTYPE,123322168,503,519,16
f_0.74,DEFAULT_VEHTYPE,123195735,509,525,16
f_0.75,DEFAULT_VEHTYPE,123195735,510,525,15
f_0.63,DEFAULT_VEHTYPE,123284038,521,537,16
f_0.64,DEFAULT_VEHTYPE,123284038,523,537,14
car3.104,DEFAULT_VEHTYPE,268162734,509,538,29
f_0.73,DEFAULT_VEHTYPE,123195735,506,539,33
f_0.79,DEFAULT_VEHTYPE,123195735,538,539,1
f_0.80,DEFAULT_VEHTYPE,123195735,541,542,1
car4.91,DEFAULT_VEHTYPE,36750787,508,546,38
car4.92,DEFAULT_VEHTYPE,36750787,516,546,30
f_0.73,DEFAULT_VEHTYPE,123467582,543,551,8
f_0.74,DEFAULT_VEHTYPE,123467582,546,552,6
f_0.61,DEFAULT_VEHTYPE,123284038,520,555,35
car2.87,DEFAULT_VEHTYPE,122837337,485,558,73
f_0.79,DEFAULT_VEHTYPE,123195735,544,560,16
f_0.80,DEFAULT_VEHTYPE,123195735,546,560,14
car4.121,DEFAULT_VEHTYPE,123322168,519,563,44
car4.122,DEFAULT_VEHTYPE,123322168,523,563,40
car4.123,DEFAULT_VEHTYPE,123322168,524,563,39
car4.124,DEFAULT_VEHTYPE,123322168,526,563,37
f_0.74,DEFAULT_VEHTYPE,123467582,556,573,17
f_0.75,DEFAULT_VEHTYPE,123467582,558,573,15
f_0.84,DEFAULT_VEHTYPE,123195735,574,575,1
f_0.85,DEFAULT_VEHTYPE,123195735,577,578,1
f_0.78,DEFAULT_VEHTYPE,123195735,542,583,41
f_0.72,DEFAULT_VEHTYPE,123467582,524,586,62
f_0.73,DEFAULT_VEHTYPE,123467582,554,589,35
f_0.63,DEFAULT_VEHTYPE,123322168,565,591,26
f_0.64,DEFAULT_VEHTYPE,123322168,568,591,23
f_0.65,DEFAULT_VEHTYPE,123322168,569,592,23
f_0.66,DEFAULT_VEHTYPE,123322168,572,593,21
car3.131,DEFAULT_VEHTYPE,GS_cluster_122690801_3137460781,549,594,45
f_0.67,DEFAULT_VEHTYPE,123322168,573,594,21
car3.113,DEFAULT_VEHTYPE,268162734,566,595,29
f_0.68,DEFAULT_VEHTYPE,123322168,575,595,20
f_0.84,DEFAULT_VEHTYPE,123195735,580,595,15
f_0.85,DEFAULT_VEHTYPE,123195735,582,595,13
f_0.69,DEFAULT_VEHTYPE,123322168,576,596,20
f_0.70,DEFAULT_VEHTYPE,123322168,578,597,19
f_0.71,DEFAULT_VEHTYPE,123322168,580,598,18
car3.115,DEFAULT_VEHTYPE,GS_cluster_122690801_3137460781,470,601,131
f_0.73,DEFAULT_VEHTYPE,123284038,594,609,15
f_0.74,DEFAULT_VEHTYPE,123284038,595,609,14
f_0.83,DEFAULT_VEHTYPE,123195735,578,609,31
f_0.89,DEFAULT_VEHTYPE,123195735,608,609,1
f_0.90,DEFAULT_VEHTYPE,123195735,611,612,1
f_0.66,DEFAULT_VEHTYPE,123322168,598,614,16
f_0.67,DEFAULT_VEHTYPE,123322168,600,614,14
f_0.68,DEFAULT_VEHTYPE,123322168,602,615,13
f_0.69,DEFAULT_VEHTYPE,123322168,604,616,12
f_0.70,DEFAULT_VEHTYPE,123322168,605,617,12
f_0.71,DEFAULT_VEHTYPE,123322168,607,618,11
f_0.64,DEFAULT_VEHTYPE,123322168,596,619,23
f_0.65,DEFAULT_VEHTYPE,123322168,597,619,22
f_0.67,DEFAULT_VEHTYPE,123322168,617,619,2
car3.103,DEFAULT_VEHTYPE,268162734,509,626,117
f_0.72,DEFAULT_VEHTYPE,123284038,591,629,38
f_0.89,DEFAULT_VEHTYPE,123195735,615,630,15
f_0.90,DEFAULT_VEHTYPE,123195735,616,630,14
f_0.84,DEFAULT_VEHTYPE,123467582,615,638,23
f_0.85,DEFAULT_VEHTYPE,123467582,616,638,22
car4.116,DEFAULT_VEHTYPE,36750787,600,640,40
car4.117,DEFAULT_VEHTYPE,36750787,603,640,37
car4.118,DEFAULT_VEHTYPE,36750787,605,640,35
f_0.94,DEFAULT_VEHTYPE,123195735,643,644,1
f_0.95,DEFAULT_VEHTYPE,123195735,646,647,1
f_0.88,DEFAULT_VEHTYPE,123195735,613,648,35
car2.111,DEFAULT_VEHTYPE,122837337,609,650,41
f_0.83,DEFAULT_VEHTYPE,123467582,612,652,40
car3.126,DEFAULT_VEHTYPE,268162734,629,658,29
car3.139,DEFAULT_VEHTYPE,GS_cluster_122690801_3137460781,619,664,45
f_0.94,DEFAULT_VEHTYPE,123195735,650,665,15
f_0.95,DEFAULT_VEHTYPE,123195735,651,665,14
car3.130,DEFAULT_VEHTYPE,GS_cluster_122690801_3137460781,549,669,120
